Date,State,Population,new_hospitalized_patients,cumulative_hospitalized_patients,current_hospitalized_patients,current_intensive_care_patients
7/1/2021,Alaska,738432,2,1635,19,10
7/2/2021,Alaska,738432,2,1637,23,9
7/3/2021,Alaska,738432,2,1639,22,7
7/4/2021,Alaska,738432,5,1644,23,6
7/5/2021,Alaska,738432,1,1645,26,8
7/6/2021,Alaska,738432,4,1649,21,7
7/7/2021,Alaska,738432,3,1652,29,7
7/8/2021,Alaska,738432,3,1655,32,6
7/9/2021,Alaska,738432,6,1661,34,6
7/10/2021,Alaska,738432,8,1669,38,10
7/11/2021,Alaska,738432,3,1672,45,12
7/12/2021,Alaska,738432,5,1677,41,10
7/13/2021,Alaska,738432,5,1682,55,12
7/14/2021,Alaska,738432,5,1687,55,13
7/15/2021,Alaska,738432,6,1693,58,16
7/16/2021,Alaska,738432,6,1699,62,16
7/17/2021,Alaska,738432,5,1704,59,16
7/18/2021,Alaska,738432,6,1710,60,18
7/19/2021,Alaska,738432,5,1715,64,18
7/20/2021,Alaska,738432,5,1720,74,20
7/21/2021,Alaska,738432,7,1727,69,19
7/22/2021,Alaska,738432,10,1737,82,19
7/23/2021,Alaska,738432,5,1742,93,22
7/24/2021,Alaska,738432,5,1747,98,23
7/25/2021,Alaska,738432,7,1754,96,21
7/26/2021,Alaska,738432,4,1758,96,23
7/27/2021,Alaska,738432,7,1765,96,21
7/28/2021,Alaska,738432,12,1777,102,23
7/29/2021,Alaska,738432,11,1788,108,26
7/30/2021,Alaska,738432,6,1794,107,29
7/31/2021,Alaska,738432,5,1799,105,29
8/1/2021,Alaska,738432,12,1811,106,30
8/2/2021,Alaska,738432,7,1818,99,29
8/3/2021,Alaska,738432,10,1828,103,28
8/4/2021,Alaska,738432,10,1838,102,24
8/5/2021,Alaska,738432,6,1844,102,27
8/6/2021,Alaska,738432,11,1855,98,26
8/7/2021,Alaska,738432,7,1862,98,23
8/8/2021,Alaska,738432,5,1867,103,23
8/9/2021,Alaska,738432,9,1876,119,19
8/10/2021,Alaska,738432,7,1883,123,18
8/11/2021,Alaska,738432,9,1892,127,19
8/12/2021,Alaska,738432,7,1899,118,27
8/13/2021,Alaska,738432,11,1910,114,27
8/14/2021,Alaska,738432,3,1913,116,25
8/15/2021,Alaska,738432,13,1926,129,26
8/16/2021,Alaska,738432,13,1939,129,28
8/17/2021,Alaska,738432,17,1956,124,30
8/18/2021,Alaska,738432,13,1969,122,33
8/19/2021,Alaska,738432,4,1973,125,32
8/20/2021,Alaska,738432,18,1991,137,36
8/21/2021,Alaska,738432,3,1994,132,35
8/22/2021,Alaska,738432,3,1997,125,35
8/23/2021,Alaska,738432,16,2013,126,34
8/24/2021,Alaska,738432,12,2025,131,39
8/25/2021,Alaska,738432,12,2037,126,35
8/26/2021,Alaska,738432,12,2049,146,37
8/27/2021,Alaska,738432,14,2063,151,41
8/28/2021,Alaska,738432,6,2069,151,38
8/29/2021,Alaska,738432,3,2072,150,37
8/30/2021,Alaska,738432,15,2087,150,34
8/31/2021,Alaska,738432,17,2104,170,42
9/1/2021,Alaska,738432,12,2116,169,40
9/2/2021,Alaska,738432,22,2138,165,36
9/3/2021,Alaska,738432,19,2157,166,36
9/4/2021,Alaska,738432,6,2163,169,34
9/5/2021,Alaska,738432,12,2175,173,33
9/6/2021,Alaska,738432,12,2187,182,37
9/7/2021,Alaska,738432,28,2215,197,34
9/8/2021,Alaska,738432,22,2237,207,37
9/9/2021,Alaska,738432,16,2253,204,37
9/10/2021,Alaska,738432,8,2261,198,43
9/11/2021,Alaska,738432,7,2268,207,50
9/12/2021,Alaska,738432,3,2271,198,49
9/13/2021,Alaska,738432,29,2300,194,53
9/14/2021,Alaska,738432,22,2322,201,52
9/15/2021,Alaska,738432,18,2340,207,51
9/16/2021,Alaska,738432,31,2371,211,49
9/17/2021,Alaska,738432,20,2391,214,53
9/18/2021,Alaska,738432,14,2405,202,50
9/19/2021,Alaska,738432,13,2418,209,46
9/20/2021,Alaska,738432,22,2440,192,46
9/21/2021,Alaska,738432,37,2477,207,46
9/22/2021,Alaska,738432,25,2502,208,44
9/23/2021,Alaska,738432,18,2520,221,47
9/24/2021,Alaska,738432,24,2544,218,48
9/25/2021,Alaska,738432,12,2556,223,49
9/26/2021,Alaska,738432,15,2571,207,44
9/27/2021,Alaska,738432,4,2575,207,47
9/28/2021,Alaska,738432,13,2588,208,45
9/29/2021,Alaska,738432,14,2602,204,45
9/30/2021,Alaska,738432,11,2613,196,43
10/1/2021,Alaska,738432,14,2627,213,41
10/2/2021,Alaska,738432,9,2636,213,40
10/3/2021,Alaska,738432,11,2647,211,41
10/4/2021,Alaska,738432,7,2654,190,38
10/5/2021,Alaska,738432,15,2669,181,36
10/6/2021,Alaska,738432,13,2682,186,29
10/7/2021,Alaska,738432,11,2693,184,37
10/8/2021,Alaska,738432,17,2710,187,37
10/9/2021,Alaska,738432,15,2725,177,35
10/10/2021,Alaska,738432,16,2741,188,29
10/11/2021,Alaska,738432,10,2751,188,30
10/12/2021,Alaska,738432,20,2771,197,32
10/13/2021,Alaska,738432,24,2795,210,35
10/14/2021,Alaska,738432,15,2810,204,32
10/15/2021,Alaska,738432,10,2820,210,33
10/16/2021,Alaska,738432,14,2834,210,38
10/17/2021,Alaska,738432,8,2842,211,38
10/18/2021,Alaska,738432,8,2850,210,39
10/19/2021,Alaska,738432,11,2861,201,41
10/20/2021,Alaska,738432,20,2881,237,43
10/21/2021,Alaska,738432,18,2899,228,44
10/22/2021,Alaska,738432,7,2906,233,46
10/23/2021,Alaska,738432,14,2920,235,50
10/24/2021,Alaska,738432,14,2934,244,49
10/25/2021,Alaska,738432,17,2951,230,50
10/26/2021,Alaska,738432,11,2962,231,48
10/27/2021,Alaska,738432,5,2967,233,50
10/28/2021,Alaska,738432,12,2979,231,47
10/29/2021,Alaska,738432,9,2988,215,42
10/30/2021,Alaska,738432,6,2994,192,43
10/31/2021,Alaska,738432,2,2996,199,44
11/1/2021,Alaska,738432,8,3004,188,47
11/2/2021,Alaska,738432,5,3009,179,40
11/3/2021,Alaska,738432,5,3014,168,37
11/4/2021,Alaska,738432,15,3029,158,38
11/5/2021,Alaska,738432,6,3035,149,32
11/6/2021,Alaska,738432,13,3048,140,29
11/7/2021,Alaska,738432,5,3053,140,26
11/8/2021,Alaska,738432,8,3061,128,33
11/9/2021,Alaska,738432,10,3071,135,33
11/10/2021,Alaska,738432,6,3077,146,32
11/11/2021,Alaska,738432,7,3084,132,26
11/12/2021,Alaska,738432,9,3093,147,31
11/13/2021,Alaska,738432,4,3097,144,31
11/14/2021,Alaska,738432,10,3107,152,32
11/15/2021,Alaska,738432,5,3112,140,24
11/16/2021,Alaska,738432,8,3120,143,27
11/17/2021,Alaska,738432,6,3126,139,26
11/18/2021,Alaska,738432,9,3135,136,27
11/19/2021,Alaska,738432,5,3140,123,26
11/20/2021,Alaska,738432,5,3145,105,28
11/21/2021,Alaska,738432,4,3149,103,26
11/22/2021,Alaska,738432,3,3152,95,26
11/23/2021,Alaska,738432,6,3158,90,19
11/24/2021,Alaska,738432,12,3170,91,16
11/25/2021,Alaska,738432,5,3175,87,14
11/26/2021,Alaska,738432,7,3182,78,15
11/27/2021,Alaska,738432,3,3185,80,14
11/28/2021,Alaska,738432,4,3189,78,15
11/29/2021,Alaska,738432,2,3191,78,18
11/30/2021,Alaska,738432,1,3192,71,17
12/1/2021,Alaska,738432,8,3200,72,22
12/2/2021,Alaska,738432,7,3207,72,20
12/3/2021,Alaska,738432,3,3210,73,22
12/4/2021,Alaska,738432,1,3211,74,23
12/5/2021,Alaska,738432,4,3215,79,21
12/6/2021,Alaska,738432,6,3221,78,18
12/7/2021,Alaska,738432,5,3226,81,14
12/8/2021,Alaska,738432,4,3230,83,20
12/9/2021,Alaska,738432,5,3235,73,15
12/10/2021,Alaska,738432,1,3236,73,12
12/11/2021,Alaska,738432,2,3238,66,10
12/12/2021,Alaska,738432,3,3241,63,9
12/13/2021,Alaska,738432,1,3242,63,12
12/14/2021,Alaska,738432,5,3247,70,15
12/15/2021,Alaska,738432,8,3255,65,17
12/16/2021,Alaska,738432,7,3262,56,16
12/17/2021,Alaska,738432,6,3268,60,18
12/18/2021,Alaska,738432,4,3272,66,17
12/19/2021,Alaska,738432,1,3273,67,18
12/20/2021,Alaska,738432,6,3279,64,16
12/21/2021,Alaska,738432,1,3280,55,15
12/22/2021,Alaska,738432,2,3282,55,12
12/23/2021,Alaska,738432,3,3285,53,12
12/24/2021,Alaska,738432,3,3288,52,12
12/25/2021,Alaska,738432,1,3289,51,15
12/26/2021,Alaska,738432,4,3293,54,15
12/27/2021,Alaska,738432,1,3294,47,11
12/28/2021,Alaska,738432,4,3298,55,11
12/29/2021,Alaska,738432,5,3303,58,14
12/30/2021,Alaska,738432,4,3307,53,13
12/31/2021,Alaska,738432,1,3308,50,13
1/1/2022,Alaska,738432,0,3308,50,12
1/2/2022,Alaska,738432,2,3310,54,15
1/3/2022,Alaska,738432,3,3313,58,15
1/4/2022,Alaska,738432,4,3317,61,15
1/5/2022,Alaska,738432,5,3322,62,14
1/6/2022,Alaska,738432,3,3325,75,16
1/7/2022,Alaska,738432,6,3331,80,15
1/8/2022,Alaska,738432,7,3338,83,13
1/9/2022,Alaska,738432,5,3343,85,14
1/10/2022,Alaska,738432,8,3351,77,10
1/11/2022,Alaska,738432,6,3357,88,13
1/12/2022,Alaska,738432,3,3360,112,11
1/13/2022,Alaska,738432,3,3363,103,10
1/14/2022,Alaska,738432,4,3367,97,10
1/15/2022,Alaska,738432,2,3369,114,13
1/16/2022,Alaska,738432,2,3371,117,12
1/17/2022,Alaska,738432,1,3372,99,12
1/18/2022,Alaska,738432,1,3373,108,14
1/19/2022,Alaska,738432,29,5666,131,14
1/20/2022,Alaska,738432,25,5691,140,17
1/21/2022,Alaska,738432,28,5719,149,14
1/22/2022,Alaska,738432,22,5741,149,16
1/23/2022,Alaska,738432,18,5759,139,21
1/24/2022,Alaska,738432,21,5780,140,16
1/25/2022,Alaska,738432,21,5801,160,17
1/26/2022,Alaska,738432,26,5827,179,17
1/27/2022,Alaska,738432,25,5852,187,22
1/28/2022,Alaska,738432,25,5877,181,26
1/29/2022,Alaska,738432,27,5904,179,22
1/30/2022,Alaska,738432,11,5915,146,19
1/31/2022,Alaska,738432,18,5933,153,19
2/1/2022,Alaska,738432,21,5954,150,18
2/2/2022,Alaska,738432,16,5970,177,20
2/3/2022,Alaska,738432,15,5985,155,20
2/4/2022,Alaska,738432,12,5997,150,17
2/5/2022,Alaska,738432,23,6020,154,17
2/6/2022,Alaska,738432,19,6039,160,21
2/7/2022,Alaska,738432,17,6056,129,24
2/8/2022,Alaska,738432,14,6070,119,21
2/9/2022,Alaska,738432,14,6084,119,21
7/1/2021,Alabama,5024279,44,52517,212,73
7/2/2021,Alabama,5024279,281,52798,574,442
7/3/2021,Alabama,5024279,40,52838,210,77
7/4/2021,Alabama,5024279,41,52879,232,75
7/5/2021,Alabama,5024279,44,52923,219,82
7/6/2021,Alabama,5024279,46,52969,235,82
7/7/2021,Alabama,5024279,49,53018,264,90
7/8/2021,Alabama,5024279,39,53057,263,91
7/9/2021,Alabama,5024279,45,53102,259,91
7/10/2021,Alabama,5024279,50,53152,277,93
7/11/2021,Alabama,5024279,45,53197,275,112
7/12/2021,Alabama,5024279,50,53247,291,114
7/13/2021,Alabama,5024279,67,53314,322,125
7/14/2021,Alabama,5024279,80,53394,351,133
7/15/2021,Alabama,5024279,74,53468,383,137
7/16/2021,Alabama,5024279,93,53561,403,132
7/17/2021,Alabama,5024279,95,53656,449,134
7/18/2021,Alabama,5024279,97,53753,470,156
7/19/2021,Alabama,5024279,118,53871,505,164
7/20/2021,Alabama,5024279,158,54029,560,182
7/21/2021,Alabama,5024279,155,54184,616,200
7/22/2021,Alabama,5024279,173,54357,670,205
7/23/2021,Alabama,5024279,185,54542,747,220
7/24/2021,Alabama,5024279,198,54740,812,233
7/25/2021,Alabama,5024279,201,54941,900,251
7/26/2021,Alabama,5024279,215,55156,976,279
7/27/2021,Alabama,5024279,262,55418,1116,289
7/28/2021,Alabama,5024279,278,55696,1198,313
7/29/2021,Alabama,5024279,279,55975,1298,351
7/30/2021,Alabama,5024279,276,56251,1364,364
7/31/2021,Alabama,5024279,288,56539,1419,401
8/1/2021,Alabama,5024279,274,56813,1483,431
8/2/2021,Alabama,5024279,242,57055,1619,447
8/3/2021,Alabama,5024279,324,57379,1726,484
8/4/2021,Alabama,5024279,299,57678,1843,514
8/5/2021,Alabama,5024279,284,57962,1890,547
8/6/2021,Alabama,5024279,317,58279,1982,551
8/7/2021,Alabama,5024279,332,58611,2045,564
8/8/2021,Alabama,5024279,320,58931,2133,595
8/9/2021,Alabama,5024279,309,59240,2207,635
8/10/2021,Alabama,5024279,392,59632,2300,645
8/11/2021,Alabama,5024279,401,60033,2419,674
8/12/2021,Alabama,5024279,414,60447,2488,697
8/13/2021,Alabama,5024279,385,60832,2515,699
8/14/2021,Alabama,5024279,345,61177,2513,724
8/15/2021,Alabama,5024279,357,61534,2616,755
8/16/2021,Alabama,5024279,349,61883,2696,762
8/17/2021,Alabama,5024279,400,62283,2799,813
8/18/2021,Alabama,5024279,363,62646,2801,824
8/19/2021,Alabama,5024279,387,63033,2812,808
8/20/2021,Alabama,5024279,372,63405,2760,821
8/21/2021,Alabama,5024279,369,63774,2762,838
8/22/2021,Alabama,5024279,342,64116,2769,825
8/23/2021,Alabama,5024279,323,64439,2819,855
8/24/2021,Alabama,5024279,377,64816,2827,858
8/25/2021,Alabama,5024279,379,65195,2910,845
8/26/2021,Alabama,5024279,390,65585,2911,864
8/27/2021,Alabama,5024279,397,65982,2957,869
8/28/2021,Alabama,5024279,334,66316,2918,869
8/29/2021,Alabama,5024279,336,66652,2936,895
8/30/2021,Alabama,5024279,398,67050,2988,906
8/31/2021,Alabama,5024279,401,67451,2952,888
9/1/2021,Alabama,5024279,358,67809,2969,894
9/2/2021,Alabama,5024279,415,68224,2933,881
9/3/2021,Alabama,5024279,350,68574,2878,877
9/4/2021,Alabama,5024279,428,69002,2843,882
9/5/2021,Alabama,5024279,323,69325,2831,852
9/6/2021,Alabama,5024279,351,69676,2865,826
9/7/2021,Alabama,5024279,308,69984,2884,843
9/8/2021,Alabama,5024279,372,70356,2773,857
9/9/2021,Alabama,5024279,365,70721,2772,831
9/10/2021,Alabama,5024279,351,71072,2718,819
9/11/2021,Alabama,5024279,295,71367,2602,770
9/12/2021,Alabama,5024279,310,71677,2591,757
9/13/2021,Alabama,5024279,237,71914,2568,783
9/14/2021,Alabama,5024279,313,72227,2494,772
9/15/2021,Alabama,5024279,284,72511,2424,767
9/16/2021,Alabama,5024279,263,72774,2317,739
9/17/2021,Alabama,5024279,241,73015,2257,732
9/18/2021,Alabama,5024279,203,73218,2152,699
9/19/2021,Alabama,5024279,168,73386,2074,693
9/20/2021,Alabama,5024279,174,73560,2033,684
9/21/2021,Alabama,5024279,202,73762,1911,651
9/22/2021,Alabama,5024279,197,73959,1844,646
9/23/2021,Alabama,5024279,177,74136,1813,598
9/24/2021,Alabama,5024279,141,74277,1756,591
9/25/2021,Alabama,5024279,149,74426,1642,564
9/26/2021,Alabama,5024279,116,74542,1639,579
9/27/2021,Alabama,5024279,114,74656,1612,556
9/28/2021,Alabama,5024279,158,74814,1548,548
9/29/2021,Alabama,5024279,132,74946,1452,511
9/30/2021,Alabama,5024279,135,75081,1392,491
10/1/2021,Alabama,5024279,111,75192,1301,471
10/2/2021,Alabama,5024279,89,75281,1217,452
10/3/2021,Alabama,5024279,98,75379,1227,453
10/4/2021,Alabama,5024279,96,75475,1211,431
10/5/2021,Alabama,5024279,130,75605,1204,418
10/6/2021,Alabama,5024279,103,75708,1141,402
10/7/2021,Alabama,5024279,114,75822,1093,394
10/8/2021,Alabama,5024279,101,75923,1036,369
10/9/2021,Alabama,5024279,96,76019,982,370
10/10/2021,Alabama,5024279,101,76120,988,361
10/11/2021,Alabama,5024279,75,76195,977,358
10/12/2021,Alabama,5024279,92,76287,919,331
10/13/2021,Alabama,5024279,80,76367,857,299
10/14/2021,Alabama,5024279,85,76452,837,286
10/15/2021,Alabama,5024279,69,76521,778,267
10/16/2021,Alabama,5024279,79,76600,756,266
10/17/2021,Alabama,5024279,74,76674,740,270
10/18/2021,Alabama,5024279,66,76740,742,257
10/19/2021,Alabama,5024279,65,76805,703,237
10/20/2021,Alabama,5024279,76,76881,671,208
10/21/2021,Alabama,5024279,69,76950,625,195
10/22/2021,Alabama,5024279,61,77011,594,186
10/23/2021,Alabama,5024279,43,77054,553,180
10/24/2021,Alabama,5024279,47,77101,559,179
10/25/2021,Alabama,5024279,61,77162,554,180
10/26/2021,Alabama,5024279,59,77221,545,173
10/27/2021,Alabama,5024279,58,77279,536,173
10/28/2021,Alabama,5024279,74,77353,524,170
10/29/2021,Alabama,5024279,46,77399,483,159
10/30/2021,Alabama,5024279,43,77442,472,157
10/31/2021,Alabama,5024279,47,77489,469,155
11/1/2021,Alabama,5024279,39,77528,472,158
11/2/2021,Alabama,5024279,43,77571,455,153
11/3/2021,Alabama,5024279,38,77609,434,147
11/4/2021,Alabama,5024279,40,77649,412,151
11/5/2021,Alabama,5024279,46,77695,398,132
11/6/2021,Alabama,5024279,40,77735,376,131
11/7/2021,Alabama,5024279,38,77773,369,133
11/8/2021,Alabama,5024279,40,77813,361,122
11/9/2021,Alabama,5024279,43,77856,360,122
11/10/2021,Alabama,5024279,36,77892,327,112
11/11/2021,Alabama,5024279,49,77941,320,107
11/12/2021,Alabama,5024279,43,77984,312,105
11/13/2021,Alabama,5024279,48,78032,303,100
11/14/2021,Alabama,5024279,34,78066,304,100
11/15/2021,Alabama,5024279,34,78100,320,111
11/16/2021,Alabama,5024279,43,78143,323,118
11/17/2021,Alabama,5024279,40,78183,341,112
11/18/2021,Alabama,5024279,42,78225,339,95
11/19/2021,Alabama,5024279,47,78272,331,101
11/20/2021,Alabama,5024279,33,78305,319,105
11/21/2021,Alabama,5024279,27,78332,319,109
11/22/2021,Alabama,5024279,35,78367,325,110
11/23/2021,Alabama,5024279,43,78410,326,112
11/24/2021,Alabama,5024279,40,78450,323,110
11/25/2021,Alabama,5024279,41,78491,298,114
11/26/2021,Alabama,5024279,37,78528,301,117
11/27/2021,Alabama,5024279,37,78565,311,125
11/28/2021,Alabama,5024279,34,78599,320,120
11/29/2021,Alabama,5024279,49,78648,332,117
11/30/2021,Alabama,5024279,56,78704,348,125
12/1/2021,Alabama,5024279,55,78759,359,125
12/2/2021,Alabama,5024279,57,78816,356,115
12/3/2021,Alabama,5024279,40,78856,362,108
12/4/2021,Alabama,5024279,49,78905,334,99
12/5/2021,Alabama,5024279,36,78941,346,97
12/6/2021,Alabama,5024279,46,78987,367,108
12/7/2021,Alabama,5024279,49,79036,364,111
12/8/2021,Alabama,5024279,54,79090,357,109
12/9/2021,Alabama,5024279,47,79137,356,105
12/10/2021,Alabama,5024279,48,79185,353,114
12/11/2021,Alabama,5024279,47,79232,367,124
12/12/2021,Alabama,5024279,50,79282,365,122
12/13/2021,Alabama,5024279,40,79322,376,126
12/14/2021,Alabama,5024279,54,79376,384,132
12/15/2021,Alabama,5024279,59,79435,397,130
12/16/2021,Alabama,5024279,57,79492,390,118
12/17/2021,Alabama,5024279,54,79546,399,124
12/18/2021,Alabama,5024279,41,79587,385,130
12/19/2021,Alabama,5024279,58,79645,403,125
12/20/2021,Alabama,5024279,53,79698,414,130
12/21/2021,Alabama,5024279,67,79765,436,126
12/22/2021,Alabama,5024279,75,79840,453,135
12/23/2021,Alabama,5024279,85,79925,459,133
12/24/2021,Alabama,5024279,76,80001,463,143
12/25/2021,Alabama,5024279,79,80080,459,143
12/26/2021,Alabama,5024279,64,80144,508,145
12/27/2021,Alabama,5024279,96,80240,553,159
12/28/2021,Alabama,5024279,146,80386,635,158
12/29/2021,Alabama,5024279,163,80549,746,172
12/30/2021,Alabama,5024279,167,80716,824,176
12/31/2021,Alabama,5024279,218,80934,897,183
1/1/2022,Alabama,5024279,173,81107,962,194
1/2/2022,Alabama,5024279,191,81298,1042,200
1/3/2022,Alabama,5024279,206,81504,1156,217
1/4/2022,Alabama,5024279,238,81742,1298,235
1/5/2022,Alabama,5024279,288,82030,1385,268
1/6/2022,Alabama,5024279,304,82334,1533,278
1/7/2022,Alabama,5024279,318,82652,1597,313
1/8/2022,Alabama,5024279,290,82942,1692,327
1/9/2022,Alabama,5024279,244,83186,1760,360
1/10/2022,Alabama,5024279,319,83505,1924,389
1/11/2022,Alabama,5024279,311,83816,2001,404
1/12/2022,Alabama,5024279,383,84199,2124,411
1/13/2022,Alabama,5024279,380,84579,2204,416
1/14/2022,Alabama,5024279,392,84971,2326,433
1/15/2022,Alabama,5024279,389,85360,2362,437
1/16/2022,Alabama,5024279,304,85664,2415,465
1/17/2022,Alabama,5024279,311,85975,2523,490
1/18/2022,Alabama,5024279,452,86427,2686,511
1/19/2022,Alabama,5024279,421,86848,2763,516
1/20/2022,Alabama,5024279,474,87322,2870,530
1/21/2022,Alabama,5024279,450,87772,2872,540
1/22/2022,Alabama,5024279,350,88122,2837,547
1/23/2022,Alabama,5024279,379,88501,2912,559
1/24/2022,Alabama,5024279,372,88873,3019,575
1/25/2022,Alabama,5024279,474,89347,3120,604
1/26/2022,Alabama,5024279,450,89797,3095,591
1/27/2022,Alabama,5024279,448,90245,3070,575
1/28/2022,Alabama,5024279,457,90702,3077,591
1/29/2022,Alabama,5024279,412,91114,2907,598
1/30/2022,Alabama,5024279,361,91475,2908,590
1/31/2022,Alabama,5024279,314,91789,2980,603
2/1/2022,Alabama,5024279,371,92160,2865,586
2/2/2022,Alabama,5024279,369,92529,2809,575
2/3/2022,Alabama,5024279,348,92877,2751,582
2/4/2022,Alabama,5024279,315,93192,2692,555
2/5/2022,Alabama,5024279,265,93457,2553,543
2/6/2022,Alabama,5024279,259,93716,2507,559
2/7/2022,Alabama,5024279,227,93943,2474,556
2/8/2022,Alabama,5024279,257,94200,2331,531
2/9/2022,Alabama,5024279,257,94457,2331,531
7/1/2021,Arkansas,2978204,71,27060,329,140
7/2/2021,Arkansas,2978204,65,27125,338,153
7/3/2021,Arkansas,2978204,70,27195,340,153
7/4/2021,Arkansas,2978204,57,27252,344,151
7/5/2021,Arkansas,2978204,55,27307,349,138
7/6/2021,Arkansas,2978204,81,27388,404,165
7/7/2021,Arkansas,2978204,103,27491,432,170
7/8/2021,Arkansas,2978204,113,27604,465,176
7/9/2021,Arkansas,2978204,108,27712,486,173
7/10/2021,Arkansas,2978204,125,27837,511,174
7/11/2021,Arkansas,2978204,87,27924,526,188
7/12/2021,Arkansas,2978204,98,28022,541,197
7/13/2021,Arkansas,2978204,106,28128,585,217
7/14/2021,Arkansas,2978204,108,28236,619,230
7/15/2021,Arkansas,2978204,133,28369,648,230
7/16/2021,Arkansas,2978204,112,28481,658,227
7/17/2021,Arkansas,2978204,115,28596,676,249
7/18/2021,Arkansas,2978204,107,28703,683,247
7/19/2021,Arkansas,2978204,102,28805,713,262
7/20/2021,Arkansas,2978204,154,28959,755,267
7/21/2021,Arkansas,2978204,138,29097,797,285
7/22/2021,Arkansas,2978204,149,29246,837,299
7/23/2021,Arkansas,2978204,149,29395,842,297
7/24/2021,Arkansas,2978204,149,29544,862,313
7/25/2021,Arkansas,2978204,131,29675,883,312
7/26/2021,Arkansas,2978204,143,29818,917,317
7/27/2021,Arkansas,2978204,171,29989,998,327
7/28/2021,Arkansas,2978204,160,30149,1026,331
7/29/2021,Arkansas,2978204,171,30320,1002,343
7/30/2021,Arkansas,2978204,161,30481,1002,355
7/31/2021,Arkansas,2978204,171,30652,1036,368
8/1/2021,Arkansas,2978204,143,30795,1059,384
8/2/2021,Arkansas,2978204,165,30960,1116,377
8/3/2021,Arkansas,2978204,175,31135,1139,390
8/4/2021,Arkansas,2978204,163,31298,1140,401
8/5/2021,Arkansas,2978204,208,31506,1174,406
8/6/2021,Arkansas,2978204,157,31663,1146,402
8/7/2021,Arkansas,2978204,175,31838,1146,400
8/8/2021,Arkansas,2978204,180,32018,1201,414
8/9/2021,Arkansas,2978204,188,32206,1269,436
8/10/2021,Arkansas,2978204,218,32424,1302,437
8/11/2021,Arkansas,2978204,236,32660,1337,431
8/12/2021,Arkansas,2978204,194,32854,1352,453
8/13/2021,Arkansas,2978204,205,33059,1362,455
8/14/2021,Arkansas,2978204,216,33275,1355,451
8/15/2021,Arkansas,2978204,154,33429,1372,464
8/16/2021,Arkansas,2978204,151,33580,1401,478
8/17/2021,Arkansas,2978204,179,33759,1377,466
8/18/2021,Arkansas,2978204,204,33963,1367,474
8/19/2021,Arkansas,2978204,226,34189,1393,488
8/20/2021,Arkansas,2978204,188,34377,1349,486
8/21/2021,Arkansas,2978204,182,34559,1327,493
8/22/2021,Arkansas,2978204,167,34726,1295,487
8/23/2021,Arkansas,2978204,124,34850,1319,500
8/24/2021,Arkansas,2978204,190,35040,1317,486
8/25/2021,Arkansas,2978204,166,35206,1326,481
8/26/2021,Arkansas,2978204,167,35373,1263,469
8/27/2021,Arkansas,2978204,196,35569,1272,459
8/28/2021,Arkansas,2978204,167,35736,1229,466
8/29/2021,Arkansas,2978204,126,35862,1208,477
8/30/2021,Arkansas,2978204,128,35990,1216,475
8/31/2021,Arkansas,2978204,172,36162,1238,467
9/1/2021,Arkansas,2978204,181,36343,1262,448
9/2/2021,Arkansas,2978204,159,36502,1245,478
9/3/2021,Arkansas,2978204,131,36633,1204,459
9/4/2021,Arkansas,2978204,157,36790,1177,438
9/5/2021,Arkansas,2978204,127,36917,1165,446
9/6/2021,Arkansas,2978204,104,37021,1133,438
9/7/2021,Arkansas,2978204,143,37164,1161,457
9/8/2021,Arkansas,2978204,138,37302,1142,418
9/9/2021,Arkansas,2978204,147,37449,1096,419
9/10/2021,Arkansas,2978204,112,37561,1060,399
9/11/2021,Arkansas,2978204,151,37712,1036,392
9/12/2021,Arkansas,2978204,109,37821,1032,374
9/13/2021,Arkansas,2978204,88,37909,1008,369
9/14/2021,Arkansas,2978204,142,38051,1029,374
9/15/2021,Arkansas,2978204,162,38213,1018,381
9/16/2021,Arkansas,2978204,146,38359,993,383
9/17/2021,Arkansas,2978204,114,38473,948,361
9/18/2021,Arkansas,2978204,127,38600,947,346
9/19/2021,Arkansas,2978204,113,38713,935,352
9/20/2021,Arkansas,2978204,100,38813,902,345
9/21/2021,Arkansas,2978204,108,38921,905,339
9/22/2021,Arkansas,2978204,112,39033,887,337
9/23/2021,Arkansas,2978204,113,39146,861,339
9/24/2021,Arkansas,2978204,106,39252,840,328
9/25/2021,Arkansas,2978204,108,39360,779,314
9/26/2021,Arkansas,2978204,82,39442,773,318
9/27/2021,Arkansas,2978204,62,39504,763,299
9/28/2021,Arkansas,2978204,71,39575,752,296
9/29/2021,Arkansas,2978204,92,39667,707,285
9/30/2021,Arkansas,2978204,78,39745,671,276
10/1/2021,Arkansas,2978204,83,39828,653,261
10/2/2021,Arkansas,2978204,76,39904,635,258
10/3/2021,Arkansas,2978204,74,39978,631,266
10/4/2021,Arkansas,2978204,62,40040,638,269
10/5/2021,Arkansas,2978204,67,40107,607,255
10/6/2021,Arkansas,2978204,78,40185,574,236
10/7/2021,Arkansas,2978204,75,40260,547,235
10/8/2021,Arkansas,2978204,81,40341,538,223
10/9/2021,Arkansas,2978204,71,40412,527,221
10/10/2021,Arkansas,2978204,60,40472,522,218
10/11/2021,Arkansas,2978204,49,40521,524,219
10/12/2021,Arkansas,2978204,70,40591,533,216
10/13/2021,Arkansas,2978204,68,40659,527,210
10/14/2021,Arkansas,2978204,58,40717,498,198
10/15/2021,Arkansas,2978204,56,40773,473,203
10/16/2021,Arkansas,2978204,55,40828,445,181
10/17/2021,Arkansas,2978204,55,40883,445,186
10/18/2021,Arkansas,2978204,45,40928,433,173
10/19/2021,Arkansas,2978204,58,40986,445,171
10/20/2021,Arkansas,2978204,66,41052,433,165
10/21/2021,Arkansas,2978204,55,41107,428,153
10/22/2021,Arkansas,2978204,52,41159,417,152
10/23/2021,Arkansas,2978204,37,41196,376,149
10/24/2021,Arkansas,2978204,57,41253,390,151
10/25/2021,Arkansas,2978204,31,41284,388,153
10/26/2021,Arkansas,2978204,51,41335,368,149
10/27/2021,Arkansas,2978204,56,41391,373,152
10/28/2021,Arkansas,2978204,46,41437,364,155
10/29/2021,Arkansas,2978204,51,41488,356,148
10/30/2021,Arkansas,2978204,48,41536,358,135
10/31/2021,Arkansas,2978204,43,41579,346,133
11/1/2021,Arkansas,2978204,32,41611,352,130
11/2/2021,Arkansas,2978204,42,41653,339,125
11/3/2021,Arkansas,2978204,53,41706,344,132
11/4/2021,Arkansas,2978204,38,41744,319,125
11/5/2021,Arkansas,2978204,46,41790,319,129
11/6/2021,Arkansas,2978204,38,41828,309,131
11/7/2021,Arkansas,2978204,33,41861,293,125
11/8/2021,Arkansas,2978204,22,41883,301,120
11/9/2021,Arkansas,2978204,37,41920,302,122
11/10/2021,Arkansas,2978204,49,41969,315,121
11/11/2021,Arkansas,2978204,49,42018,303,120
11/12/2021,Arkansas,2978204,40,42058,306,129
11/13/2021,Arkansas,2978204,43,42101,297,134
11/14/2021,Arkansas,2978204,30,42131,294,124
11/15/2021,Arkansas,2978204,28,42159,297,129
11/16/2021,Arkansas,2978204,33,42192,307,133
11/17/2021,Arkansas,2978204,56,42248,327,128
11/18/2021,Arkansas,2978204,53,42301,335,129
11/19/2021,Arkansas,2978204,52,42353,327,131
11/20/2021,Arkansas,2978204,54,42407,332,137
11/21/2021,Arkansas,2978204,46,42453,352,134
11/22/2021,Arkansas,2978204,41,42494,348,136
11/23/2021,Arkansas,2978204,42,42536,353,135
11/24/2021,Arkansas,2978204,58,42594,367,144
11/25/2021,Arkansas,2978204,61,42655,351,147
11/26/2021,Arkansas,2978204,53,42708,360,151
11/27/2021,Arkansas,2978204,41,42749,385,161
11/28/2021,Arkansas,2978204,60,42809,397,162
11/29/2021,Arkansas,2978204,49,42858,413,169
11/30/2021,Arkansas,2978204,45,42903,409,164
12/1/2021,Arkansas,2978204,71,42974,438,170
12/2/2021,Arkansas,2978204,84,43058,447,165
12/3/2021,Arkansas,2978204,75,43133,429,159
12/4/2021,Arkansas,2978204,72,43205,438,171
12/5/2021,Arkansas,2978204,67,43272,443,158
12/6/2021,Arkansas,2978204,61,43333,447,162
12/7/2021,Arkansas,2978204,82,43415,446,172
12/8/2021,Arkansas,2978204,70,43485,458,173
12/9/2021,Arkansas,2978204,79,43564,478,189
12/10/2021,Arkansas,2978204,73,43637,487,196
12/11/2021,Arkansas,2978204,61,43698,488,199
12/12/2021,Arkansas,2978204,70,43768,493,197
12/13/2021,Arkansas,2978204,53,43821,503,204
12/14/2021,Arkansas,2978204,60,43881,517,204
12/15/2021,Arkansas,2978204,91,43972,529,202
12/16/2021,Arkansas,2978204,95,44067,525,210
12/17/2021,Arkansas,2978204,96,44163,551,227
12/18/2021,Arkansas,2978204,77,44240,526,214
12/19/2021,Arkansas,2978204,67,44307,533,209
12/20/2021,Arkansas,2978204,53,44360,524,208
12/21/2021,Arkansas,2978204,62,44422,512,205
12/22/2021,Arkansas,2978204,86,44508,494,193
12/23/2021,Arkansas,2978204,71,44579,499,182
12/24/2021,Arkansas,2978204,75,44654,486,184
12/25/2021,Arkansas,2978204,63,44717,489,174
12/26/2021,Arkansas,2978204,71,44788,514,188
12/27/2021,Arkansas,2978204,78,44866,543,192
12/28/2021,Arkansas,2978204,107,44973,581,196
12/29/2021,Arkansas,2978204,124,45097,590,193
12/30/2021,Arkansas,2978204,94,45191,599,195
12/31/2021,Arkansas,2978204,117,45308,626,202
1/1/2022,Arkansas,2978204,112,45420,637,205
1/2/2022,Arkansas,2978204,130,45550,687,212
1/3/2022,Arkansas,2978204,102,45652,722,225
1/4/2022,Arkansas,2978204,156,45808,787,234
1/5/2022,Arkansas,2978204,153,45961,824,253
1/6/2022,Arkansas,2978204,169,46130,885,260
1/7/2022,Arkansas,2978204,176,46306,909,257
1/8/2022,Arkansas,2978204,162,46468,900,261
1/9/2022,Arkansas,2978204,160,46628,968,283
1/10/2022,Arkansas,2978204,169,46797,1042,303
1/11/2022,Arkansas,2978204,207,47004,1113,317
1/12/2022,Arkansas,2978204,205,47209,1174,326
1/13/2022,Arkansas,2978204,223,47432,1229,313
1/14/2022,Arkansas,2978204,241,47673,1245,317
1/15/2022,Arkansas,2978204,234,47907,1250,327
1/16/2022,Arkansas,2978204,179,48086,1284,332
1/17/2022,Arkansas,2978204,218,48304,1350,337
1/18/2022,Arkansas,2978204,282,48586,1433,336
1/19/2022,Arkansas,2978204,314,48900,1534,342
1/20/2022,Arkansas,2978204,286,49186,1586,359
1/21/2022,Arkansas,2978204,279,49465,1576,366
1/22/2022,Arkansas,2978204,274,49739,1542,368
1/23/2022,Arkansas,2978204,208,49947,1529,371
1/24/2022,Arkansas,2978204,270,50217,1635,383
1/25/2022,Arkansas,2978204,325,50542,1725,410
1/26/2022,Arkansas,2978204,304,50846,1753,424
1/27/2022,Arkansas,2978204,299,51145,1726,413
1/28/2022,Arkansas,2978204,258,51403,1712,426
1/29/2022,Arkansas,2978204,243,51646,1641,411
1/30/2022,Arkansas,2978204,225,51871,1665,435
1/31/2022,Arkansas,2978204,219,52090,1661,434
2/1/2022,Arkansas,2978204,302,52392,1699,441
2/2/2022,Arkansas,2978204,275,52667,1680,438
2/3/2022,Arkansas,2978204,258,52925,1597,446
2/4/2022,Arkansas,2978204,171,53096,1578,414
2/5/2022,Arkansas,2978204,190,53286,1495,403
2/6/2022,Arkansas,2978204,181,53467,1458,411
2/7/2022,Arkansas,2978204,164,53631,1421,376
2/8/2022,Arkansas,2978204,194,53825,1386,366
2/9/2022,Arkansas,2978204,195,54020,1385,366
8/24/2021,American Samoa,55689,0,0,0,0
8/25/2021,American Samoa,55689,0,0,0,0
8/26/2021,American Samoa,55689,0,0,0,0
8/27/2021,American Samoa,55689,0,0,0,0
8/28/2021,American Samoa,55689,0,0,0,0
8/29/2021,American Samoa,55689,0,0,0,0
8/30/2021,American Samoa,55689,0,0,0,0
8/31/2021,American Samoa,55689,0,0,0,0
9/1/2021,American Samoa,55689,0,0,0,0
9/2/2021,American Samoa,55689,0,0,0,0
9/3/2021,American Samoa,55689,0,0,0,0
9/4/2021,American Samoa,55689,0,0,0,0
9/5/2021,American Samoa,55689,0,0,0,0
9/6/2021,American Samoa,55689,0,0,0,0
9/7/2021,American Samoa,55689,0,0,0,0
9/8/2021,American Samoa,55689,0,0,0,0
9/9/2021,American Samoa,55689,0,0,0,0
9/10/2021,American Samoa,55689,0,0,0,0
9/11/2021,American Samoa,55689,0,0,0,0
9/12/2021,American Samoa,55689,0,0,0,0
9/13/2021,American Samoa,55689,0,0,0,0
9/14/2021,American Samoa,55689,0,0,0,0
9/15/2021,American Samoa,55689,0,0,0,0
9/16/2021,American Samoa,55689,0,0,0,0
9/17/2021,American Samoa,55689,0,0,0,0
9/18/2021,American Samoa,55689,0,0,0,0
9/19/2021,American Samoa,55689,0,0,0,0
9/20/2021,American Samoa,55689,0,0,0,0
9/21/2021,American Samoa,55689,0,0,0,0
9/22/2021,American Samoa,55689,0,0,0,0
9/23/2021,American Samoa,55689,0,0,0,0
9/24/2021,American Samoa,55689,0,0,0,0
9/25/2021,American Samoa,55689,0,0,0,0
9/26/2021,American Samoa,55689,0,0,0,0
9/27/2021,American Samoa,55689,0,0,0,0
9/28/2021,American Samoa,55689,0,0,0,0
9/29/2021,American Samoa,55689,0,0,0,0
9/30/2021,American Samoa,55689,0,0,0,0
10/1/2021,American Samoa,55689,0,0,0,0
10/2/2021,American Samoa,55689,0,0,0,0
10/3/2021,American Samoa,55689,0,0,0,0
10/4/2021,American Samoa,55689,0,0,0,0
10/5/2021,American Samoa,55689,0,0,0,0
10/6/2021,American Samoa,55689,0,0,0,0
10/7/2021,American Samoa,55689,0,0,0,0
10/8/2021,American Samoa,55689,0,0,0,0
10/9/2021,American Samoa,55689,0,0,0,0
10/10/2021,American Samoa,55689,0,0,0,0
10/11/2021,American Samoa,55689,0,0,0,0
10/12/2021,American Samoa,55689,0,0,0,0
10/13/2021,American Samoa,55689,0,0,0,0
10/14/2021,American Samoa,55689,0,0,0,0
10/15/2021,American Samoa,55689,0,0,0,0
10/16/2021,American Samoa,55689,0,0,0,0
10/17/2021,American Samoa,55689,0,0,0,0
10/18/2021,American Samoa,55689,0,0,0,0
10/19/2021,American Samoa,55689,0,0,0,0
10/20/2021,American Samoa,55689,0,0,0,0
10/21/2021,American Samoa,55689,0,0,0,0
10/22/2021,American Samoa,55689,0,0,0,0
10/23/2021,American Samoa,55689,0,0,0,0
10/24/2021,American Samoa,55689,0,0,0,0
10/25/2021,American Samoa,55689,0,0,0,0
10/26/2021,American Samoa,55689,0,0,0,0
10/27/2021,American Samoa,55689,0,0,0,0
10/28/2021,American Samoa,55689,0,0,0,0
10/29/2021,American Samoa,55689,0,0,0,0
10/30/2021,American Samoa,55689,0,0,0,0
10/31/2021,American Samoa,55689,0,0,0,0
11/1/2021,American Samoa,55689,0,0,0,0
11/2/2021,American Samoa,55689,0,0,0,0
11/3/2021,American Samoa,55689,0,0,0,0
11/4/2021,American Samoa,55689,0,0,0,0
11/5/2021,American Samoa,55689,0,0,0,0
11/6/2021,American Samoa,55689,0,0,0,0
11/7/2021,American Samoa,55689,0,0,0,0
11/8/2021,American Samoa,55689,0,0,0,0
11/9/2021,American Samoa,55689,0,0,0,0
11/10/2021,American Samoa,55689,0,0,0,0
11/11/2021,American Samoa,55689,0,0,0,0
11/12/2021,American Samoa,55689,0,0,0,0
11/13/2021,American Samoa,55689,0,0,0,0
11/14/2021,American Samoa,55689,0,0,0,0
11/15/2021,American Samoa,55689,0,0,0,0
11/16/2021,American Samoa,55689,0,0,0,0
11/17/2021,American Samoa,55689,0,0,0,0
11/18/2021,American Samoa,55689,0,0,0,0
11/19/2021,American Samoa,55689,0,0,0,0
11/20/2021,American Samoa,55689,0,0,0,0
11/21/2021,American Samoa,55689,0,0,0,0
11/22/2021,American Samoa,55689,0,0,0,0
11/23/2021,American Samoa,55689,0,0,0,0
11/24/2021,American Samoa,55689,0,0,0,0
11/25/2021,American Samoa,55689,0,0,0,0
11/26/2021,American Samoa,55689,0,0,0,0
11/27/2021,American Samoa,55689,0,0,0,0
11/28/2021,American Samoa,55689,0,0,0,0
11/29/2021,American Samoa,55689,0,0,0,0
11/30/2021,American Samoa,55689,0,0,0,0
12/1/2021,American Samoa,55689,0,0,0,0
12/2/2021,American Samoa,55689,0,0,0,0
12/3/2021,American Samoa,55689,0,0,0,0
12/4/2021,American Samoa,55689,0,0,0,0
12/5/2021,American Samoa,55689,0,0,0,0
12/6/2021,American Samoa,55689,0,0,0,0
12/7/2021,American Samoa,55689,0,0,0,0
12/8/2021,American Samoa,55689,0,0,0,0
12/9/2021,American Samoa,55689,0,0,0,0
12/10/2021,American Samoa,55689,0,0,0,0
12/11/2021,American Samoa,55689,0,0,0,0
12/12/2021,American Samoa,55689,0,0,0,0
12/13/2021,American Samoa,55689,0,0,0,0
12/14/2021,American Samoa,55689,0,0,0,0
12/15/2021,American Samoa,55689,0,0,0,0
12/16/2021,American Samoa,55689,0,0,0,0
12/17/2021,American Samoa,55689,0,0,0,0
12/18/2021,American Samoa,55689,0,0,0,0
12/19/2021,American Samoa,55689,0,0,0,0
12/20/2021,American Samoa,55689,0,0,0,0
12/21/2021,American Samoa,55689,0,0,0,0
12/22/2021,American Samoa,55689,0,0,0,0
12/23/2021,American Samoa,55689,0,0,0,0
12/24/2021,American Samoa,55689,0,0,0,0
12/25/2021,American Samoa,55689,0,0,0,0
12/26/2021,American Samoa,55689,0,0,0,0
12/27/2021,American Samoa,55689,0,0,0,0
12/28/2021,American Samoa,55689,0,0,0,0
12/29/2021,American Samoa,55689,0,0,0,0
12/30/2021,American Samoa,55689,0,0,0,0
12/31/2021,American Samoa,55689,0,0,0,0
1/1/2022,American Samoa,55689,0,0,0,0
1/2/2022,American Samoa,55689,0,0,0,0
1/3/2022,American Samoa,55689,0,0,0,0
1/4/2022,American Samoa,55689,0,0,0,0
1/5/2022,American Samoa,55689,0,0,0,0
1/6/2022,American Samoa,55689,0,0,0,0
1/7/2022,American Samoa,55689,0,0,0,0
1/8/2022,American Samoa,55689,0,0,0,0
1/9/2022,American Samoa,55689,0,0,0,0
1/10/2022,American Samoa,55689,0,0,0,0
1/11/2022,American Samoa,55689,0,0,0,0
1/12/2022,American Samoa,55689,0,0,0,0
1/13/2022,American Samoa,55689,0,0,0,0
1/14/2022,American Samoa,55689,0,0,0,0
1/15/2022,American Samoa,55689,0,0,0,0
1/16/2022,American Samoa,55689,0,0,0,0
1/17/2022,American Samoa,55689,0,0,0,0
1/18/2022,American Samoa,55689,0,0,0,0
1/19/2022,American Samoa,55689,0,0,0,0
1/20/2022,American Samoa,55689,0,0,0,0
1/21/2022,American Samoa,55689,0,0,0,0
1/22/2022,American Samoa,55689,0,0,0,0
1/23/2022,American Samoa,55689,0,0,0,0
1/24/2022,American Samoa,55689,0,0,0,0
1/25/2022,American Samoa,55689,0,0,0,0
1/26/2022,American Samoa,55689,0,0,0,0
1/27/2022,American Samoa,55689,0,0,0,0
1/28/2022,American Samoa,55689,0,0,0,0
1/29/2022,American Samoa,55689,0,0,0,0
1/30/2022,American Samoa,55689,0,0,0,0
1/31/2022,American Samoa,55689,0,0,0,0
2/1/2022,American Samoa,55689,0,0,0,0
2/2/2022,American Samoa,55689,0,0,0,0
2/3/2022,American Samoa,55689,0,0,0,0
2/4/2022,American Samoa,55689,0,0,0,0
2/5/2022,American Samoa,55689,0,0,0,0
2/6/2022,American Samoa,55689,0,0,0,0
2/7/2022,American Samoa,55689,0,0,0,0
2/8/2022,American Samoa,55689,0,0,0,0
2/9/2022,American Samoa,55689,0,0,0,0
7/1/2021,Arizona,6828065,75,63402,346,88
7/2/2021,Arizona,6828065,78,63480,369,89
7/3/2021,Arizona,6828065,73,63553,385,98
7/4/2021,Arizona,6828065,60,63613,390,107
7/5/2021,Arizona,6828065,46,63659,381,111
7/6/2021,Arizona,6828065,62,63721,383,113
7/7/2021,Arizona,6828065,65,63786,408,117
7/8/2021,Arizona,6828065,64,63850,392,121
7/9/2021,Arizona,6828065,68,63918,374,117
7/10/2021,Arizona,6828065,62,63980,408,115
7/11/2021,Arizona,6828065,68,64048,432,124
7/12/2021,Arizona,6828065,77,64125,446,131
7/13/2021,Arizona,6828065,93,64218,472,135
7/14/2021,Arizona,6828065,95,64313,496,130
7/15/2021,Arizona,6828065,91,64404,515,130
7/16/2021,Arizona,6828065,107,64511,551,134
7/17/2021,Arizona,6828065,108,64619,556,139
7/18/2021,Arizona,6828065,97,64716,582,144
7/19/2021,Arizona,6828065,93,64809,580,159
7/20/2021,Arizona,6828065,85,64894,587,174
7/21/2021,Arizona,6828065,116,65010,625,173
7/22/2021,Arizona,6828065,109,65119,648,179
7/23/2021,Arizona,6828065,116,65235,672,194
7/24/2021,Arizona,6828065,98,65333,663,190
7/25/2021,Arizona,6828065,115,65448,685,198
7/26/2021,Arizona,6828065,111,65559,720,211
7/27/2021,Arizona,6828065,145,65704,797,242
7/28/2021,Arizona,6828065,126,65830,826,246
7/29/2021,Arizona,6828065,157,65987,869,251
7/30/2021,Arizona,6828065,186,66173,897,262
7/31/2021,Arizona,6828065,160,66333,932,273
8/1/2021,Arizona,6828065,151,66484,958,262
8/2/2021,Arizona,6828065,144,66628,979,259
8/3/2021,Arizona,6828065,172,66800,1036,278
8/4/2021,Arizona,6828065,166,66966,1042,283
8/5/2021,Arizona,6828065,169,67135,1104,293
8/6/2021,Arizona,6828065,188,67323,1142,319
8/7/2021,Arizona,6828065,158,67481,1112,310
8/8/2021,Arizona,6828065,158,67639,1151,313
8/9/2021,Arizona,6828065,183,67822,1228,340
8/10/2021,Arizona,6828065,199,68021,1268,346
8/11/2021,Arizona,6828065,182,68203,1277,346
8/12/2021,Arizona,6828065,178,68381,1339,354
8/13/2021,Arizona,6828065,201,68582,1356,364
8/14/2021,Arizona,6828065,208,68790,1412,374
8/15/2021,Arizona,6828065,199,68989,1482,385
8/16/2021,Arizona,6828065,200,69189,1504,390
8/17/2021,Arizona,6828065,208,69397,1569,406
8/18/2021,Arizona,6828065,204,69601,1620,416
8/19/2021,Arizona,6828065,185,69786,1622,423
8/20/2021,Arizona,6828065,211,69997,1655,437
8/21/2021,Arizona,6828065,233,70230,1680,436
8/22/2021,Arizona,6828065,183,70413,1687,456
8/23/2021,Arizona,6828065,180,70593,1727,468
8/24/2021,Arizona,6828065,214,70807,1773,469
8/25/2021,Arizona,6828065,196,71003,1717,466
8/26/2021,Arizona,6828065,204,71207,1732,469
8/27/2021,Arizona,6828065,208,71415,1731,482
8/28/2021,Arizona,6828065,229,71644,1714,479
8/29/2021,Arizona,6828065,214,71858,1731,495
8/30/2021,Arizona,6828065,214,72072,1747,493
8/31/2021,Arizona,6828065,265,72337,1784,505
9/1/2021,Arizona,6828065,217,72554,1802,510
9/2/2021,Arizona,6828065,257,72811,1799,503
9/3/2021,Arizona,6828065,223,73034,1824,507
9/4/2021,Arizona,6828065,221,73255,1778,502
9/5/2021,Arizona,6828065,212,73467,1795,506
9/6/2021,Arizona,6828065,215,73682,1813,522
9/7/2021,Arizona,6828065,222,73904,1842,530
9/8/2021,Arizona,6828065,255,74159,1880,524
9/9/2021,Arizona,6828065,235,74394,1884,519
9/10/2021,Arizona,6828065,206,74600,1860,522
9/11/2021,Arizona,6828065,201,74801,1830,524
9/12/2021,Arizona,6828065,200,75001,1846,525
9/13/2021,Arizona,6828065,208,75209,1872,545
9/14/2021,Arizona,6828065,215,75424,1862,549
9/15/2021,Arizona,6828065,212,75636,1839,533
9/16/2021,Arizona,6828065,217,75853,1789,530
9/17/2021,Arizona,6828065,199,76052,1747,521
9/18/2021,Arizona,6828065,185,76237,1667,498
9/19/2021,Arizona,6828065,194,76431,1691,489
9/20/2021,Arizona,6828065,189,76620,1696,493
9/21/2021,Arizona,6828065,192,76812,1692,493
9/22/2021,Arizona,6828065,201,77013,1591,462
9/23/2021,Arizona,6828065,187,77200,1609,466
9/24/2021,Arizona,6828065,187,77387,1606,460
9/25/2021,Arizona,6828065,181,77568,1568,465
9/26/2021,Arizona,6828065,181,77749,1585,482
9/27/2021,Arizona,6828065,155,77904,1570,485
9/28/2021,Arizona,6828065,197,78101,1545,455
9/29/2021,Arizona,6828065,175,78276,1554,449
9/30/2021,Arizona,6828065,180,78456,1526,425
10/1/2021,Arizona,6828065,189,78645,1537,415
10/2/2021,Arizona,6828065,175,78820,1496,422
10/3/2021,Arizona,6828065,149,78969,1517,419
10/4/2021,Arizona,6828065,149,79118,1537,419
10/5/2021,Arizona,6828065,210,79328,1553,408
10/6/2021,Arizona,6828065,185,79513,1544,415
10/7/2021,Arizona,6828065,176,79689,1500,409
10/8/2021,Arizona,6828065,166,79855,1509,412
10/9/2021,Arizona,6828065,177,80032,1488,406
10/10/2021,Arizona,6828065,173,80205,1502,400
10/11/2021,Arizona,6828065,153,80358,1494,405
10/12/2021,Arizona,6828065,160,80518,1494,395
10/13/2021,Arizona,6828065,208,80726,1503,401
10/14/2021,Arizona,6828065,184,80910,1449,394
10/15/2021,Arizona,6828065,181,81091,1444,396
10/16/2021,Arizona,6828065,169,81260,1443,401
10/17/2021,Arizona,6828065,173,81433,1436,408
10/18/2021,Arizona,6828065,158,81591,1482,414
10/19/2021,Arizona,6828065,204,81795,1523,431
10/20/2021,Arizona,6828065,166,81961,1487,428
10/21/2021,Arizona,6828065,191,82152,1497,429
10/22/2021,Arizona,6828065,179,82331,1486,419
10/23/2021,Arizona,6828065,181,82512,1469,410
10/24/2021,Arizona,6828065,186,82698,1481,409
10/25/2021,Arizona,6828065,186,82884,1531,421
10/26/2021,Arizona,6828065,208,83092,1536,404
10/27/2021,Arizona,6828065,206,83298,1553,412
10/28/2021,Arizona,6828065,200,83498,1575,415
10/29/2021,Arizona,6828065,221,83719,1600,419
10/30/2021,Arizona,6828065,216,83935,1618,403
10/31/2021,Arizona,6828065,188,84123,1635,394
11/1/2021,Arizona,6828065,200,84323,1644,395
11/2/2021,Arizona,6828065,238,84561,1651,403
11/3/2021,Arizona,6828065,227,84788,1677,410
11/4/2021,Arizona,6828065,253,85041,1702,408
11/5/2021,Arizona,6828065,245,85286,1738,416
11/6/2021,Arizona,6828065,222,85508,1710,442
11/7/2021,Arizona,6828065,235,85743,1774,449
11/8/2021,Arizona,6828065,244,85987,1841,481
11/9/2021,Arizona,6828065,254,86241,1892,496
11/10/2021,Arizona,6828065,240,86481,1936,493
11/11/2021,Arizona,6828065,277,86758,1934,484
11/12/2021,Arizona,6828065,259,87017,1923,497
11/13/2021,Arizona,6828065,270,87287,1964,521
11/14/2021,Arizona,6828065,267,87554,1994,514
11/15/2021,Arizona,6828065,267,87821,2082,543
11/16/2021,Arizona,6828065,287,88108,2162,540
11/17/2021,Arizona,6828065,280,88388,2199,543
11/18/2021,Arizona,6828065,262,88650,2179,543
11/19/2021,Arizona,6828065,259,88909,2194,547
11/20/2021,Arizona,6828065,305,89214,2169,540
11/21/2021,Arizona,6828065,254,89468,2206,556
11/22/2021,Arizona,6828065,267,89735,2250,573
11/23/2021,Arizona,6828065,350,90085,2369,584
11/24/2021,Arizona,6828065,299,90384,2371,595
11/25/2021,Arizona,6828065,299,90683,2369,613
11/26/2021,Arizona,6828065,288,90971,2382,618
11/27/2021,Arizona,6828065,273,91244,2396,613
11/28/2021,Arizona,6828065,310,91554,2432,613
11/29/2021,Arizona,6828065,269,91823,2476,619
11/30/2021,Arizona,6828065,328,92151,2503,623
12/1/2021,Arizona,6828065,339,92490,2541,606
12/2/2021,Arizona,6828065,318,92808,2538,600
12/3/2021,Arizona,6828065,324,93132,2526,612
12/4/2021,Arizona,6828065,350,93482,2536,619
12/5/2021,Arizona,6828065,306,93788,2584,621
12/6/2021,Arizona,6828065,297,94085,2616,646
12/7/2021,Arizona,6828065,312,94397,2626,650
12/8/2021,Arizona,6828065,309,94706,2636,647
12/9/2021,Arizona,6828065,316,95022,2596,659
12/10/2021,Arizona,6828065,321,95343,2624,664
12/11/2021,Arizona,6828065,304,95647,2569,650
12/12/2021,Arizona,6828065,272,95919,2550,638
12/13/2021,Arizona,6828065,259,96178,2515,630
12/14/2021,Arizona,6828065,286,96464,2521,633
12/15/2021,Arizona,6828065,266,96730,2498,609
12/16/2021,Arizona,6828065,274,97004,2443,616
12/17/2021,Arizona,6828065,265,97269,2362,615
12/18/2021,Arizona,6828065,274,97543,2281,591
12/19/2021,Arizona,6828065,261,97804,2285,602
12/20/2021,Arizona,6828065,248,98052,2289,609
12/21/2021,Arizona,6828065,277,98329,2259,598
12/22/2021,Arizona,6828065,289,98618,2240,583
12/23/2021,Arizona,6828065,267,98885,2214,553
12/24/2021,Arizona,6828065,261,99146,2123,547
12/25/2021,Arizona,6828065,233,99379,2051,546
12/26/2021,Arizona,6828065,215,99594,2067,532
12/27/2021,Arizona,6828065,249,99843,2065,532
12/28/2021,Arizona,6828065,302,100145,2122,530
12/29/2021,Arizona,6828065,315,100460,2172,552
12/30/2021,Arizona,6828065,322,100782,2133,527
12/31/2021,Arizona,6828065,329,101111,2112,520
1/1/2022,Arizona,6828065,319,101430,2135,502
1/2/2022,Arizona,6828065,323,101753,2262,523
1/3/2022,Arizona,6828065,311,102064,2286,510
1/4/2022,Arizona,6828065,350,102414,2355,531
1/5/2022,Arizona,6828065,387,102801,2409,531
1/6/2022,Arizona,6828065,377,103178,2482,530
1/7/2022,Arizona,6828065,416,103594,2545,544
1/8/2022,Arizona,6828065,447,104041,2615,547
1/9/2022,Arizona,6828065,444,104485,2692,530
1/10/2022,Arizona,6828065,394,104879,2775,549
1/11/2022,Arizona,6828065,481,105360,2906,550
1/12/2022,Arizona,6828065,474,105834,3010,547
1/13/2022,Arizona,6828065,513,106347,3009,541
1/14/2022,Arizona,6828065,516,106863,3088,545
1/15/2022,Arizona,6828065,516,107379,3083,516
1/16/2022,Arizona,6828065,496,107875,3166,516
1/17/2022,Arizona,6828065,462,108337,3185,523
1/18/2022,Arizona,6828065,566,108903,3273,519
1/19/2022,Arizona,6828065,556,109459,3443,518
1/20/2022,Arizona,6828065,549,110008,3412,535
1/21/2022,Arizona,6828065,580,110588,3375,511
1/22/2022,Arizona,6828065,590,111178,3424,531
1/23/2022,Arizona,6828065,539,111717,3505,545
1/24/2022,Arizona,6828065,482,112199,3480,556
1/25/2022,Arizona,6828065,525,112724,3471,561
1/26/2022,Arizona,6828065,612,113336,3563,589
1/27/2022,Arizona,6828065,551,113887,3565,571
1/28/2022,Arizona,6828065,516,114403,3442,562
1/29/2022,Arizona,6828065,513,114916,3359,580
1/30/2022,Arizona,6828065,463,115379,3360,571
1/31/2022,Arizona,6828065,403,115782,3307,575
2/1/2022,Arizona,6828065,456,116238,3167,542
2/2/2022,Arizona,6828065,468,116706,3094,553
2/3/2022,Arizona,6828065,457,117163,2994,533
2/4/2022,Arizona,6828065,438,117601,2863,500
2/5/2022,Arizona,6828065,421,118022,2694,472
2/6/2022,Arizona,6828065,375,118397,2651,478
2/7/2022,Arizona,6828065,285,118682,2561,465
2/8/2022,Arizona,6828065,364,119046,2367,427
2/9/2022,Arizona,6828065,364,119410,2367,427
7/1/2021,California,39144818,165,244825,1107,285
7/2/2021,California,39144818,188,245013,1149,280
7/3/2021,California,39144818,177,245190,1125,282
7/4/2021,California,39144818,182,245372,1162,275
7/5/2021,California,39144818,172,245544,1181,299
7/6/2021,California,39144818,192,245736,1242,301
7/7/2021,California,39144818,210,245946,1346,318
7/8/2021,California,39144818,203,246149,1365,321
7/9/2021,California,39144818,228,246377,1403,325
7/10/2021,California,39144818,237,246614,1434,326
7/11/2021,California,39144818,215,246829,1514,340
7/12/2021,California,39144818,269,247098,1612,356
7/13/2021,California,39144818,269,247367,1686,373
7/14/2021,California,39144818,264,247631,1764,385
7/15/2021,California,39144818,311,247942,1823,410
7/16/2021,California,39144818,313,248255,1919,431
7/17/2021,California,39144818,313,248568,1960,470
7/18/2021,California,39144818,315,248883,2020,493
7/19/2021,California,39144818,333,249216,2179,541
7/20/2021,California,39144818,437,249653,2354,557
7/21/2021,California,39144818,407,250060,2461,575
7/22/2021,California,39144818,443,250503,2596,586
7/23/2021,California,39144818,448,250951,2737,596
7/24/2021,California,39144818,453,251404,2839,615
7/25/2021,California,39144818,459,251863,3041,675
7/26/2021,California,39144818,504,252367,3242,729
7/27/2021,California,39144818,537,252904,3398,782
7/28/2021,California,39144818,618,253522,3680,793
7/29/2021,California,39144818,589,254111,3797,845
7/30/2021,California,39144818,671,254782,4068,886
7/31/2021,California,39144818,636,255418,4205,951
8/1/2021,California,39144818,568,255986,4285,977
8/2/2021,California,39144818,636,256622,4714,1055
8/3/2021,California,39144818,762,257384,4926,1091
8/4/2021,California,39144818,771,258155,5187,1129
8/5/2021,California,39144818,813,258968,5411,1166
8/6/2021,California,39144818,825,259793,5638,1231
8/7/2021,California,39144818,838,260631,5819,1288
8/8/2021,California,39144818,831,261462,6068,1329
8/9/2021,California,39144818,817,262279,6351,1381
8/10/2021,California,39144818,976,263255,6640,1437
8/11/2021,California,39144818,858,264113,6648,1479
8/12/2021,California,39144818,888,265001,6797,1528
8/13/2021,California,39144818,926,265927,6911,1595
8/14/2021,California,39144818,1021,266948,7032,1469
8/15/2021,California,39144818,853,267801,7289,1649
8/16/2021,California,39144818,896,268697,7496,1704
8/17/2021,California,39144818,1034,269731,7782,1731
8/18/2021,California,39144818,1036,270767,7871,1775
8/19/2021,California,39144818,991,271758,7932,1855
8/20/2021,California,39144818,994,272752,7949,1891
8/21/2021,California,39144818,1009,273761,7984,1881
8/22/2021,California,39144818,953,274714,8193,1921
8/23/2021,California,39144818,918,275632,8309,2001
8/24/2021,California,39144818,971,276603,8377,2028
8/25/2021,California,39144818,948,277551,8363,1979
8/26/2021,California,39144818,1004,278555,8429,2004
8/27/2021,California,39144818,951,279506,8375,1987
8/28/2021,California,39144818,954,280460,8307,2052
8/29/2021,California,39144818,890,281350,8367,2089
8/30/2021,California,39144818,883,282233,8431,2126
8/31/2021,California,39144818,906,283139,8456,2105
9/1/2021,California,39144818,948,284087,8446,2092
9/2/2021,California,39144818,884,284971,8339,2105
9/3/2021,California,39144818,864,285835,8179,2083
9/4/2021,California,39144818,824,286659,7928,2022
9/5/2021,California,39144818,766,287425,7837,2005
9/6/2021,California,39144818,713,288138,7787,2020
9/7/2021,California,39144818,745,288883,7731,2033
9/8/2021,California,39144818,759,289642,7632,1998
9/9/2021,California,39144818,756,290398,7473,1958
9/10/2021,California,39144818,732,291130,7213,1932
9/11/2021,California,39144818,752,291882,7051,1887
9/12/2021,California,39144818,603,292485,6912,1857
9/13/2021,California,39144818,650,293135,6877,1853
9/14/2021,California,39144818,663,293798,6728,1849
9/15/2021,California,39144818,675,294473,6639,1820
9/16/2021,California,39144818,674,295147,6515,1810
9/17/2021,California,39144818,602,295749,6356,1777
9/18/2021,California,39144818,582,296331,6139,1746
9/19/2021,California,39144818,564,296895,6081,1723
9/20/2021,California,39144818,564,297459,6105,1713
9/21/2021,California,39144818,606,298065,6063,1694
9/22/2021,California,39144818,576,298641,5952,1673
9/23/2021,California,39144818,580,299221,5910,1638
9/24/2021,California,39144818,551,299772,5708,1586
9/25/2021,California,39144818,524,300296,5539,1572
9/26/2021,California,39144818,453,300749,5465,1554
9/27/2021,California,39144818,449,301198,5367,1495
9/28/2021,California,39144818,486,301684,5270,1444
9/29/2021,California,39144818,481,302165,5120,1415
9/30/2021,California,39144818,436,302601,4985,1380
10/1/2021,California,39144818,443,303044,4793,1332
10/2/2021,California,39144818,452,303496,4667,1316
10/3/2021,California,39144818,365,303861,4585,1288
10/4/2021,California,39144818,358,304219,4553,1264
10/5/2021,California,39144818,428,304647,4428,1255
10/6/2021,California,39144818,460,305107,4397,1207
10/7/2021,California,39144818,405,305512,4202,1172
10/8/2021,California,39144818,435,305947,4116,1126
10/9/2021,California,39144818,423,306370,4036,1110
10/10/2021,California,39144818,381,306751,4006,1097
10/11/2021,California,39144818,326,307077,3973,1083
10/12/2021,California,39144818,441,307518,3962,1076
10/13/2021,California,39144818,347,307865,3834,1054
10/14/2021,California,39144818,414,308279,3745,1035
10/15/2021,California,39144818,448,308727,3734,1034
10/16/2021,California,39144818,444,309171,3727,1033
10/17/2021,California,39144818,356,309527,3725,1016
10/18/2021,California,39144818,381,309908,3728,997
10/19/2021,California,39144818,410,310318,3707,980
10/20/2021,California,39144818,403,310721,3669,989
10/21/2021,California,39144818,418,311139,3697,962
10/22/2021,California,39144818,443,311582,3727,980
10/23/2021,California,39144818,474,312056,3673,967
10/24/2021,California,39144818,439,312495,3721,950
10/25/2021,California,39144818,401,312896,3814,979
10/26/2021,California,39144818,470,313366,3882,995
10/27/2021,California,39144818,429,313795,3859,1002
10/28/2021,California,39144818,447,314242,3869,980
10/29/2021,California,39144818,442,314684,3902,976
10/30/2021,California,39144818,455,315139,3923,965
10/31/2021,California,39144818,404,315543,3893,955
11/1/2021,California,39144818,389,315932,3918,963
11/2/2021,California,39144818,430,316362,3933,945
11/3/2021,California,39144818,487,316849,3954,962
11/4/2021,California,39144818,431,317280,3941,956
11/5/2021,California,39144818,409,317689,3882,957
11/6/2021,California,39144818,445,318134,3831,952
11/7/2021,California,39144818,354,318488,3732,940
11/8/2021,California,39144818,353,318841,3735,942
11/9/2021,California,39144818,417,319258,3703,936
11/10/2021,California,39144818,392,319650,3677,963
11/11/2021,California,39144818,375,320025,3605,976
11/12/2021,California,39144818,355,320380,3559,965
11/13/2021,California,39144818,376,320756,3504,965
11/14/2021,California,39144818,384,321140,3500,939
11/15/2021,California,39144818,324,321464,3503,938
11/16/2021,California,39144818,430,321894,3475,924
11/17/2021,California,39144818,343,322237,3453,926
11/18/2021,California,39144818,351,322588,3361,934
11/19/2021,California,39144818,342,322930,3326,909
11/20/2021,California,39144818,349,323279,3278,884
11/21/2021,California,39144818,296,323575,3221,884
11/22/2021,California,39144818,335,323910,3213,875
11/23/2021,California,39144818,336,324246,3153,855
11/24/2021,California,39144818,362,324608,3178,869
11/25/2021,California,39144818,334,324942,3087,860
11/26/2021,California,39144818,276,325218,3105,845
11/27/2021,California,39144818,339,325557,3142,834
11/28/2021,California,39144818,336,325893,3176,848
11/29/2021,California,39144818,353,326246,3268,879
11/30/2021,California,39144818,382,326628,3236,866
12/1/2021,California,39144818,386,327014,3235,885
12/2/2021,California,39144818,354,327368,3261,867
12/3/2021,California,39144818,376,327744,3248,860
12/4/2021,California,39144818,336,328080,3184,857
12/5/2021,California,39144818,353,328433,3256,858
12/6/2021,California,39144818,330,328763,3302,856
12/7/2021,California,39144818,423,329186,3386,862
12/8/2021,California,39144818,434,329620,3436,866
12/9/2021,California,39144818,405,330025,3433,848
12/10/2021,California,39144818,419,330444,3542,896
12/11/2021,California,39144818,381,330825,3491,905
12/12/2021,California,39144818,374,331199,3525,942
12/13/2021,California,39144818,366,331565,3642,969
12/14/2021,California,39144818,382,331947,3668,943
12/15/2021,California,39144818,399,332346,3671,949
12/16/2021,California,39144818,406,332752,3659,949
12/17/2021,California,39144818,400,333152,3651,942
12/18/2021,California,39144818,406,333558,3615,964
12/19/2021,California,39144818,341,333899,3597,952
12/20/2021,California,39144818,329,334228,3572,947
12/21/2021,California,39144818,421,334649,3646,954
12/22/2021,California,39144818,450,335099,3690,965
12/23/2021,California,39144818,449,335548,3733,960
12/24/2021,California,39144818,477,336025,3692,969
12/25/2021,California,39144818,545,336570,3895,983
12/26/2021,California,39144818,563,337133,4098,1020
12/27/2021,California,39144818,683,337816,4483,1050
12/28/2021,California,39144818,825,338641,4843,1050
12/29/2021,California,39144818,995,339636,5182,1096
12/30/2021,California,39144818,1018,340654,5557,1122
12/31/2021,California,39144818,1088,341742,5981,1175
1/1/2022,California,39144818,1070,342812,6389,1226
1/2/2022,California,39144818,1157,343969,6866,1265
1/3/2022,California,39144818,1233,345202,7495,1282
1/4/2022,California,39144818,1474,346676,8116,1398
1/5/2022,California,39144818,1673,348349,8750,1434
1/6/2022,California,39144818,1802,350151,9398,1511
1/7/2022,California,39144818,1890,352041,10223,1576
1/8/2022,California,39144818,1921,353962,10683,1617
1/9/2022,California,39144818,1765,355727,11204,1705
1/10/2022,California,39144818,1791,357518,11902,1790
1/11/2022,California,39144818,2032,359550,12446,1890
1/12/2022,California,39144818,2253,361803,13099,1944
1/13/2022,California,39144818,2276,364079,13521,2026
1/14/2022,California,39144818,2275,366354,13989,2081
1/15/2022,California,39144818,2239,368593,14125,2129
1/16/2022,California,39144818,2020,370613,14466,2170
1/17/2022,California,39144818,1995,372608,14909,2305
1/18/2022,California,39144818,2256,374864,15418,2390
1/19/2022,California,39144818,2090,376954,15740,2462
1/20/2022,California,39144818,2250,379204,15772,2481
1/21/2022,California,39144818,2288,381492,15802,2526
1/22/2022,California,39144818,2078,383570,15550,2551
1/23/2022,California,39144818,1898,385468,15567,2591
1/24/2022,California,39144818,1803,387271,15565,2591
1/25/2022,California,39144818,2106,389377,15551,2581
1/26/2022,California,39144818,2109,391486,15468,2567
1/27/2022,California,39144818,1811,393297,15029,2549
1/28/2022,California,39144818,1925,395222,14755,2549
1/29/2022,California,39144818,1705,396927,14094,2513
1/30/2022,California,39144818,1473,398400,13702,2495
1/31/2022,California,39144818,1448,399848,13567,2460
2/1/2022,California,39144818,1606,401454,13177,2400
2/2/2022,California,39144818,1595,403049,12973,2319
2/3/2022,California,39144818,1385,404434,12411,2257
2/4/2022,California,39144818,1334,405768,11784,2190
2/5/2022,California,39144818,1282,407050,11085,2069
2/6/2022,California,39144818,1086,408136,10773,2038
2/7/2022,California,39144818,1060,409196,10553,1975
2/8/2022,California,39144818,1213,410409,10134,1936
2/9/2022,California,39144818,1213,411622,10134,1936
7/1/2021,Colorado,5456574,47,32980,277,92
7/2/2021,Colorado,5456574,50,33030,280,98
7/3/2021,Colorado,5456574,55,33085,292,105
7/4/2021,Colorado,5456574,48,33133,292,96
7/5/2021,Colorado,5456574,41,33174,290,100
7/6/2021,Colorado,5456574,60,33234,275,103
7/7/2021,Colorado,5456574,59,33293,280,96
7/8/2021,Colorado,5456574,58,33351,286,107
7/9/2021,Colorado,5456574,52,33403,281,105
7/10/2021,Colorado,5456574,54,33457,252,95
7/11/2021,Colorado,5456574,38,33495,255,99
7/12/2021,Colorado,5456574,37,33532,248,95
7/13/2021,Colorado,5456574,54,33586,255,101
7/14/2021,Colorado,5456574,44,33630,261,103
7/15/2021,Colorado,5456574,45,33675,269,103
7/16/2021,Colorado,5456574,55,33730,277,109
7/17/2021,Colorado,5456574,50,33780,252,101
7/18/2021,Colorado,5456574,33,33813,265,86
7/19/2021,Colorado,5456574,51,33864,294,98
7/20/2021,Colorado,5456574,61,33925,278,95
7/21/2021,Colorado,5456574,51,33976,258,93
7/22/2021,Colorado,5456574,54,34030,272,99
7/23/2021,Colorado,5456574,67,34097,282,105
7/24/2021,Colorado,5456574,72,34169,288,104
7/25/2021,Colorado,5456574,48,34217,280,100
7/26/2021,Colorado,5456574,67,34284,296,99
7/27/2021,Colorado,5456574,70,34354,294,107
7/28/2021,Colorado,5456574,70,34424,305,113
7/29/2021,Colorado,5456574,79,34503,317,120
7/30/2021,Colorado,5456574,59,34562,323,123
7/31/2021,Colorado,5456574,68,34630,334,119
8/1/2021,Colorado,5456574,73,34703,356,138
8/2/2021,Colorado,5456574,64,34767,372,155
8/3/2021,Colorado,5456574,91,34858,373,157
8/4/2021,Colorado,5456574,88,34946,394,161
8/5/2021,Colorado,5456574,89,35035,410,165
8/6/2021,Colorado,5456574,82,35117,426,172
8/7/2021,Colorado,5456574,93,35210,446,177
8/8/2021,Colorado,5456574,94,35304,470,190
8/9/2021,Colorado,5456574,97,35401,512,209
8/10/2021,Colorado,5456574,96,35497,486,199
8/11/2021,Colorado,5456574,79,35576,497,204
8/12/2021,Colorado,5456574,91,35667,509,199
8/13/2021,Colorado,5456574,85,35752,499,187
8/14/2021,Colorado,5456574,100,35852,526,201
8/15/2021,Colorado,5456574,116,35968,560,214
8/16/2021,Colorado,5456574,115,36083,564,210
8/17/2021,Colorado,5456574,117,36200,593,226
8/18/2021,Colorado,5456574,114,36314,608,236
8/19/2021,Colorado,5456574,143,36457,615,243
8/20/2021,Colorado,5456574,130,36587,646,249
8/21/2021,Colorado,5456574,119,36706,645,249
8/22/2021,Colorado,5456574,114,36820,635,255
8/23/2021,Colorado,5456574,110,36930,652,259
8/24/2021,Colorado,5456574,132,37062,673,258
8/25/2021,Colorado,5456574,97,37159,671,258
8/26/2021,Colorado,5456574,127,37286,694,267
8/27/2021,Colorado,5456574,145,37431,750,286
8/28/2021,Colorado,5456574,114,37545,746,296
8/29/2021,Colorado,5456574,136,37681,800,308
8/30/2021,Colorado,5456574,137,37818,812,304
8/31/2021,Colorado,5456574,160,37978,812,293
9/1/2021,Colorado,5456574,149,38127,815,305
9/2/2021,Colorado,5456574,147,38274,822,294
9/3/2021,Colorado,5456574,135,38409,842,308
9/4/2021,Colorado,5456574,139,38548,830,310
9/5/2021,Colorado,5456574,126,38674,829,313
9/6/2021,Colorado,5456574,133,38807,836,321
9/7/2021,Colorado,5456574,141,38948,867,344
9/8/2021,Colorado,5456574,160,39108,915,344
9/9/2021,Colorado,5456574,152,39260,906,339
9/10/2021,Colorado,5456574,131,39391,917,340
9/11/2021,Colorado,5456574,143,39534,902,344
9/12/2021,Colorado,5456574,127,39661,920,356
9/13/2021,Colorado,5456574,127,39788,926,363
9/14/2021,Colorado,5456574,145,39933,933,375
9/15/2021,Colorado,5456574,135,40068,903,364
9/16/2021,Colorado,5456574,138,40206,890,345
9/17/2021,Colorado,5456574,143,40349,900,341
9/18/2021,Colorado,5456574,143,40492,895,342
9/19/2021,Colorado,5456574,128,40620,895,335
9/20/2021,Colorado,5456574,142,40762,920,347
9/21/2021,Colorado,5456574,147,40909,921,345
9/22/2021,Colorado,5456574,136,41045,913,347
9/23/2021,Colorado,5456574,140,41185,923,337
9/24/2021,Colorado,5456574,143,41328,915,325
9/25/2021,Colorado,5456574,160,41488,906,323
9/26/2021,Colorado,5456574,111,41599,908,331
9/27/2021,Colorado,5456574,127,41726,921,325
9/28/2021,Colorado,5456574,167,41893,913,319
9/29/2021,Colorado,5456574,144,42037,888,302
9/30/2021,Colorado,5456574,144,42181,890,296
10/1/2021,Colorado,5456574,128,42309,866,299
10/2/2021,Colorado,5456574,153,42462,891,299
10/3/2021,Colorado,5456574,129,42591,911,293
10/4/2021,Colorado,5456574,115,42706,900,305
10/5/2021,Colorado,5456574,189,42895,944,320
10/6/2021,Colorado,5456574,162,43057,982,319
10/7/2021,Colorado,5456574,141,43198,961,313
10/8/2021,Colorado,5456574,160,43358,927,322
10/9/2021,Colorado,5456574,165,43523,914,323
10/10/2021,Colorado,5456574,172,43695,983,329
10/11/2021,Colorado,5456574,157,43852,1006,340
10/12/2021,Colorado,5456574,173,44025,1015,344
10/13/2021,Colorado,5456574,199,44224,1037,343
10/14/2021,Colorado,5456574,153,44377,1037,345
10/15/2021,Colorado,5456574,203,44580,1055,362
10/16/2021,Colorado,5456574,181,44761,1045,360
10/17/2021,Colorado,5456574,179,44940,1079,361
10/18/2021,Colorado,5456574,173,45113,1082,373
10/19/2021,Colorado,5456574,200,45313,1105,363
10/20/2021,Colorado,5456574,185,45498,1151,378
10/21/2021,Colorado,5456574,223,45721,1158,370
10/22/2021,Colorado,5456574,188,45909,1132,354
10/23/2021,Colorado,5456574,196,46105,1137,380
10/24/2021,Colorado,5456574,158,46263,1157,386
10/25/2021,Colorado,5456574,188,46451,1177,387
10/26/2021,Colorado,5456574,229,46680,1209,384
10/27/2021,Colorado,5456574,201,46881,1194,396
10/28/2021,Colorado,5456574,202,47083,1195,390
10/29/2021,Colorado,5456574,209,47292,1227,374
10/30/2021,Colorado,5456574,172,47464,1246,360
10/31/2021,Colorado,5456574,176,47640,1259,403
11/1/2021,Colorado,5456574,175,47815,1284,419
11/2/2021,Colorado,5456574,238,48053,1276,428
11/3/2021,Colorado,5456574,211,48264,1322,417
11/4/2021,Colorado,5456574,241,48505,1330,424
11/5/2021,Colorado,5456574,238,48743,1334,421
11/6/2021,Colorado,5456574,253,48996,1346,446
11/7/2021,Colorado,5456574,210,49206,1364,460
11/8/2021,Colorado,5456574,241,49447,1441,461
11/9/2021,Colorado,5456574,263,49710,1452,463
11/10/2021,Colorado,5456574,255,49965,1460,481
11/11/2021,Colorado,5456574,223,50188,1467,485
11/12/2021,Colorado,5456574,254,50442,1473,493
11/13/2021,Colorado,5456574,218,50660,1415,486
11/14/2021,Colorado,5456574,211,50871,1414,480
11/15/2021,Colorado,5456574,210,51081,1466,505
11/16/2021,Colorado,5456574,294,51375,1489,498
11/17/2021,Colorado,5456574,259,51634,1501,495
11/18/2021,Colorado,5456574,266,51900,1524,512
11/19/2021,Colorado,5456574,230,52130,1503,503
11/20/2021,Colorado,5456574,233,52363,1490,509
11/21/2021,Colorado,5456574,206,52569,1487,505
11/22/2021,Colorado,5456574,249,52818,1510,516
11/23/2021,Colorado,5456574,270,53088,1516,517
11/24/2021,Colorado,5456574,252,53340,1492,521
11/25/2021,Colorado,5456574,223,53563,1482,524
11/26/2021,Colorado,5456574,178,53741,1474,518
11/27/2021,Colorado,5456574,228,53969,1492,519
11/28/2021,Colorado,5456574,181,54150,1473,503
11/29/2021,Colorado,5456574,200,54350,1460,533
11/30/2021,Colorado,5456574,252,54602,1460,522
12/1/2021,Colorado,5456574,224,54826,1449,508
12/2/2021,Colorado,5456574,220,55046,1435,510
12/3/2021,Colorado,5456574,216,55262,1443,497
12/4/2021,Colorado,5456574,208,55470,1383,488
12/5/2021,Colorado,5456574,176,55646,1394,480
12/6/2021,Colorado,5456574,180,55826,1431,508
12/7/2021,Colorado,5456574,218,56044,1436,528
12/8/2021,Colorado,5456574,192,56236,1408,504
12/9/2021,Colorado,5456574,194,56430,1380,485
12/10/2021,Colorado,5456574,190,56620,1364,457
12/11/2021,Colorado,5456574,178,56798,1331,459
12/12/2021,Colorado,5456574,134,56932,1317,464
12/13/2021,Colorado,5456574,146,57078,1294,470
12/14/2021,Colorado,5456574,179,57257,1275,473
12/15/2021,Colorado,5456574,185,57442,1250,465
12/16/2021,Colorado,5456574,166,57608,1217,471
12/17/2021,Colorado,5456574,143,57751,1189,457
12/18/2021,Colorado,5456574,104,57855,1115,433
12/19/2021,Colorado,5456574,79,57934,1079,419
12/20/2021,Colorado,5456574,149,58083,1116,424
12/21/2021,Colorado,5456574,161,58244,1047,384
12/22/2021,Colorado,5456574,170,58414,1028,382
12/23/2021,Colorado,5456574,194,58608,1009,375
12/24/2021,Colorado,5456574,209,58817,1016,370
12/25/2021,Colorado,5456574,211,59028,1016,361
12/26/2021,Colorado,5456574,141,59169,1039,378
12/27/2021,Colorado,5456574,192,59361,1063,371
12/28/2021,Colorado,5456574,278,59639,1110,372
12/29/2021,Colorado,5456574,306,59945,1138,369
12/30/2021,Colorado,5456574,301,60246,1135,360
12/31/2021,Colorado,5456574,217,60463,1165,354
1/1/2022,Colorado,5456574,229,60692,1135,351
1/2/2022,Colorado,5456574,231,60923,1189,367
1/3/2022,Colorado,5456574,292,61215,1170,364
1/4/2022,Colorado,5456574,384,61599,1330,391
1/5/2022,Colorado,5456574,380,61979,1372,396
1/6/2022,Colorado,5456574,338,62317,1405,407
1/7/2022,Colorado,5456574,303,62620,1439,419
1/8/2022,Colorado,5456574,403,63023,1491,411
1/9/2022,Colorado,5456574,304,63327,1523,421
1/10/2022,Colorado,5456574,285,63612,1512,418
1/11/2022,Colorado,5456574,372,63984,1581,422
1/12/2022,Colorado,5456574,411,64395,1624,428
1/13/2022,Colorado,5456574,369,64764,1701,418
1/14/2022,Colorado,5456574,350,65114,1713,428
1/15/2022,Colorado,5456574,355,65469,1680,437
1/16/2022,Colorado,5456574,279,65748,1671,442
1/17/2022,Colorado,5456574,276,66024,1674,441
1/18/2022,Colorado,5456574,348,66372,1698,414
1/19/2022,Colorado,5456574,349,66721,1698,434
1/20/2022,Colorado,5456574,302,67023,1695,424
1/21/2022,Colorado,5456574,320,67343,1663,405
1/22/2022,Colorado,5456574,234,67577,1656,410
1/23/2022,Colorado,5456574,251,67828,1630,400
1/24/2022,Colorado,5456574,231,68059,1594,397
1/25/2022,Colorado,5456574,329,68388,1613,395
1/26/2022,Colorado,5456574,320,68708,1587,381
1/27/2022,Colorado,5456574,340,69048,1499,361
1/28/2022,Colorado,5456574,314,69362,1446,356
1/29/2022,Colorado,5456574,314,69676,1346,341
1/30/2022,Colorado,5456574,267,69943,1335,337
1/31/2022,Colorado,5456574,167,70110,1287,339
2/1/2022,Colorado,5456574,232,70342,1260,339
2/2/2022,Colorado,5456574,190,70532,1273,322
2/3/2022,Colorado,5456574,182,70714,1221,313
2/4/2022,Colorado,5456574,137,70851,1176,305
2/5/2022,Colorado,5456574,160,71011,1155,301
2/6/2022,Colorado,5456574,140,71151,1103,275
2/7/2022,Colorado,5456574,111,71262,1055,270
2/8/2022,Colorado,5456574,168,71430,994,267
2/9/2022,Colorado,5456574,168,71598,993,267
7/1/2021,Connecticut,3590886,8,22263,50,10
7/2/2021,Connecticut,3590886,11,22274,41,7
7/3/2021,Connecticut,3590886,4,22278,41,6
7/4/2021,Connecticut,3590886,5,22283,35,8
7/5/2021,Connecticut,3590886,5,22288,35,8
7/6/2021,Connecticut,3590886,2,22290,35,9
7/7/2021,Connecticut,3590886,8,22298,33,8
7/8/2021,Connecticut,3590886,7,22305,30,8
7/9/2021,Connecticut,3590886,9,22314,31,10
7/10/2021,Connecticut,3590886,10,22324,40,9
7/11/2021,Connecticut,3590886,3,22327,38,7
7/12/2021,Connecticut,3590886,8,22335,38,11
7/13/2021,Connecticut,3590886,10,22345,31,10
7/14/2021,Connecticut,3590886,16,22361,41,11
7/15/2021,Connecticut,3590886,7,22368,47,12
7/16/2021,Connecticut,3590886,11,22379,47,13
7/17/2021,Connecticut,3590886,12,22391,61,15
7/18/2021,Connecticut,3590886,5,22396,52,16
7/19/2021,Connecticut,3590886,11,22407,57,17
7/20/2021,Connecticut,3590886,18,22425,61,16
7/21/2021,Connecticut,3590886,11,22436,71,17
7/22/2021,Connecticut,3590886,12,22448,81,19
7/23/2021,Connecticut,3590886,25,22473,93,24
7/24/2021,Connecticut,3590886,23,22496,104,26
7/25/2021,Connecticut,3590886,17,22513,112,29
7/26/2021,Connecticut,3590886,15,22528,105,27
7/27/2021,Connecticut,3590886,20,22548,105,29
7/28/2021,Connecticut,3590886,24,22572,118,26
7/29/2021,Connecticut,3590886,24,22596,121,31
7/30/2021,Connecticut,3590886,26,22622,129,30
7/31/2021,Connecticut,3590886,25,22647,150,30
8/1/2021,Connecticut,3590886,19,22666,153,28
8/2/2021,Connecticut,3590886,34,22700,166,27
8/3/2021,Connecticut,3590886,42,22742,167,27
8/4/2021,Connecticut,3590886,30,22772,159,33
8/5/2021,Connecticut,3590886,37,22809,180,32
8/6/2021,Connecticut,3590886,37,22846,194,40
8/7/2021,Connecticut,3590886,27,22873,216,40
8/8/2021,Connecticut,3590886,37,22910,214,38
8/9/2021,Connecticut,3590886,28,22938,222,36
8/10/2021,Connecticut,3590886,39,22977,233,46
8/11/2021,Connecticut,3590886,41,23018,253,51
8/12/2021,Connecticut,3590886,60,23078,265,53
8/13/2021,Connecticut,3590886,59,23137,289,53
8/14/2021,Connecticut,3590886,42,23179,292,54
8/15/2021,Connecticut,3590886,29,23208,289,53
8/16/2021,Connecticut,3590886,47,23255,322,60
8/17/2021,Connecticut,3590886,63,23318,350,67
8/18/2021,Connecticut,3590886,34,23352,349,70
8/19/2021,Connecticut,3590886,54,23406,341,75
8/20/2021,Connecticut,3590886,55,23461,356,81
8/21/2021,Connecticut,3590886,54,23515,357,82
8/22/2021,Connecticut,3590886,66,23581,375,87
8/23/2021,Connecticut,3590886,41,23622,394,93
8/24/2021,Connecticut,3590886,61,23683,382,93
8/25/2021,Connecticut,3590886,58,23741,390,81
8/26/2021,Connecticut,3590886,58,23799,388,88
8/27/2021,Connecticut,3590886,48,23847,389,93
8/28/2021,Connecticut,3590886,53,23900,377,93
8/29/2021,Connecticut,3590886,40,23940,394,99
8/30/2021,Connecticut,3590886,34,23974,376,90
8/31/2021,Connecticut,3590886,47,24021,378,96
9/1/2021,Connecticut,3590886,40,24061,371,101
9/2/2021,Connecticut,3590886,54,24115,380,101
9/3/2021,Connecticut,3590886,44,24159,381,103
9/4/2021,Connecticut,3590886,35,24194,355,102
9/5/2021,Connecticut,3590886,40,24234,360,101
9/6/2021,Connecticut,3590886,45,24279,366,103
9/7/2021,Connecticut,3590886,37,24316,366,104
9/8/2021,Connecticut,3590886,58,24374,357,102
9/9/2021,Connecticut,3590886,46,24420,373,100
9/10/2021,Connecticut,3590886,43,24463,353,102
9/11/2021,Connecticut,3590886,53,24516,348,96
9/12/2021,Connecticut,3590886,41,24557,334,96
9/13/2021,Connecticut,3590886,33,24590,339,91
9/14/2021,Connecticut,3590886,42,24632,330,97
9/15/2021,Connecticut,3590886,40,24672,329,86
9/16/2021,Connecticut,3590886,46,24718,342,99
9/17/2021,Connecticut,3590886,35,24753,319,94
9/18/2021,Connecticut,3590886,41,24794,308,87
9/19/2021,Connecticut,3590886,26,24820,313,89
9/20/2021,Connecticut,3590886,40,24860,295,87
9/21/2021,Connecticut,3590886,23,24883,270,81
9/22/2021,Connecticut,3590886,44,24927,288,83
9/23/2021,Connecticut,3590886,39,24966,288,82
9/24/2021,Connecticut,3590886,28,24994,265,73
9/25/2021,Connecticut,3590886,44,25038,263,70
9/26/2021,Connecticut,3590886,26,25064,267,67
9/27/2021,Connecticut,3590886,29,25093,258,70
9/28/2021,Connecticut,3590886,38,25131,251,74
9/29/2021,Connecticut,3590886,36,25167,238,70
9/30/2021,Connecticut,3590886,37,25204,247,65
10/1/2021,Connecticut,3590886,47,25251,237,57
10/2/2021,Connecticut,3590886,36,25287,247,50
10/3/2021,Connecticut,3590886,35,25322,244,44
10/4/2021,Connecticut,3590886,27,25349,237,46
10/5/2021,Connecticut,3590886,31,25380,232,39
10/6/2021,Connecticut,3590886,47,25427,235,44
10/7/2021,Connecticut,3590886,34,25461,239,47
10/8/2021,Connecticut,3590886,31,25492,235,47
10/9/2021,Connecticut,3590886,29,25521,246,50
10/10/2021,Connecticut,3590886,34,25555,248,63
10/11/2021,Connecticut,3590886,20,25575,236,65
10/12/2021,Connecticut,3590886,44,25619,247,66
10/13/2021,Connecticut,3590886,27,25646,246,68
10/14/2021,Connecticut,3590886,32,25678,238,68
10/15/2021,Connecticut,3590886,33,25711,244,69
10/16/2021,Connecticut,3590886,33,25744,259,73
10/17/2021,Connecticut,3590886,19,25763,255,73
10/18/2021,Connecticut,3590886,34,25797,252,79
10/19/2021,Connecticut,3590886,20,25817,227,76
10/20/2021,Connecticut,3590886,36,25853,230,70
10/21/2021,Connecticut,3590886,27,25880,218,69
10/22/2021,Connecticut,3590886,35,25915,218,59
10/23/2021,Connecticut,3590886,29,25944,212,58
10/24/2021,Connecticut,3590886,21,25965,218,65
10/25/2021,Connecticut,3590886,25,25990,203,58
10/26/2021,Connecticut,3590886,26,26016,197,54
10/27/2021,Connecticut,3590886,25,26041,196,61
10/28/2021,Connecticut,3590886,27,26068,195,60
10/29/2021,Connecticut,3590886,26,26094,201,59
10/30/2021,Connecticut,3590886,33,26127,209,49
10/31/2021,Connecticut,3590886,23,26150,210,51
11/1/2021,Connecticut,3590886,17,26167,204,53
11/2/2021,Connecticut,3590886,36,26203,216,52
11/3/2021,Connecticut,3590886,24,26227,213,47
11/4/2021,Connecticut,3590886,21,26248,202,47
11/5/2021,Connecticut,3590886,34,26282,199,50
11/6/2021,Connecticut,3590886,36,26318,209,53
11/7/2021,Connecticut,3590886,30,26348,213,53
11/8/2021,Connecticut,3590886,37,26385,233,59
11/9/2021,Connecticut,3590886,33,26418,239,57
11/10/2021,Connecticut,3590886,32,26450,243,51
11/11/2021,Connecticut,3590886,40,26490,230,51
11/12/2021,Connecticut,3590886,26,26516,239,53
11/13/2021,Connecticut,3590886,38,26554,249,56
11/14/2021,Connecticut,3590886,23,26577,240,49
11/15/2021,Connecticut,3590886,32,26609,244,46
11/16/2021,Connecticut,3590886,34,26643,250,53
11/17/2021,Connecticut,3590886,29,26672,246,50
11/18/2021,Connecticut,3590886,44,26716,253,56
11/19/2021,Connecticut,3590886,39,26755,242,58
11/20/2021,Connecticut,3590886,45,26800,268,60
11/21/2021,Connecticut,3590886,39,26839,274,60
11/22/2021,Connecticut,3590886,33,26872,286,64
11/23/2021,Connecticut,3590886,64,26936,304,67
11/24/2021,Connecticut,3590886,37,26973,317,66
11/25/2021,Connecticut,3590886,54,27027,304,67
11/26/2021,Connecticut,3590886,20,27047,302,63
11/27/2021,Connecticut,3590886,73,27120,344,73
11/28/2021,Connecticut,3590886,57,27177,360,75
11/29/2021,Connecticut,3590886,41,27218,367,77
11/30/2021,Connecticut,3590886,61,27279,388,76
12/1/2021,Connecticut,3590886,75,27354,422,85
12/2/2021,Connecticut,3590886,72,27426,429,94
12/3/2021,Connecticut,3590886,71,27497,449,97
12/4/2021,Connecticut,3590886,84,27581,475,107
12/5/2021,Connecticut,3590886,76,27657,506,111
12/6/2021,Connecticut,3590886,73,27730,527,112
12/7/2021,Connecticut,3590886,107,27837,584,130
12/8/2021,Connecticut,3590886,94,27931,582,139
12/9/2021,Connecticut,3590886,99,28030,593,150
12/10/2021,Connecticut,3590886,96,28126,600,143
12/11/2021,Connecticut,3590886,117,28243,631,136
12/12/2021,Connecticut,3590886,96,28339,657,135
12/13/2021,Connecticut,3590886,93,28432,690,150
12/14/2021,Connecticut,3590886,114,28546,721,159
12/15/2021,Connecticut,3590886,103,28649,725,155
12/16/2021,Connecticut,3590886,114,28763,745,156
12/17/2021,Connecticut,3590886,122,28885,794,166
12/18/2021,Connecticut,3590886,137,29022,819,168
12/19/2021,Connecticut,3590886,98,29120,844,174
12/20/2021,Connecticut,3590886,88,29208,850,173
12/21/2021,Connecticut,3590886,123,29331,836,174
12/22/2021,Connecticut,3590886,113,29444,858,182
12/23/2021,Connecticut,3590886,119,29563,870,183
12/24/2021,Connecticut,3590886,107,29670,886,184
12/25/2021,Connecticut,3590886,93,29763,916,190
12/26/2021,Connecticut,3590886,94,29857,941,180
12/27/2021,Connecticut,3590886,96,29953,980,177
12/28/2021,Connecticut,3590886,202,30155,1128,198
12/29/2021,Connecticut,3590886,220,30375,1191,198
12/30/2021,Connecticut,3590886,241,30616,1282,225
12/31/2021,Connecticut,3590886,262,30878,1352,231
1/1/2022,Connecticut,3590886,164,31042,1401,240
1/2/2022,Connecticut,3590886,261,31303,1499,248
1/3/2022,Connecticut,3590886,259,31562,1608,250
1/4/2022,Connecticut,3590886,256,31818,1706,268
1/5/2022,Connecticut,3590886,290,32108,1857,264
1/6/2022,Connecticut,3590886,323,32431,1889,260
1/7/2022,Connecticut,3590886,337,32768,1945,274
1/8/2022,Connecticut,3590886,271,33039,1925,272
1/9/2022,Connecticut,3590886,252,33291,1958,280
1/10/2022,Connecticut,3590886,244,33535,1941,289
1/11/2022,Connecticut,3590886,286,33821,2014,286
1/12/2022,Connecticut,3590886,305,34126,2031,268
1/13/2022,Connecticut,3590886,293,34419,2008,297
1/14/2022,Connecticut,3590886,283,34702,1995,291
1/15/2022,Connecticut,3590886,278,34980,1955,290
1/16/2022,Connecticut,3590886,203,35183,1958,285
1/17/2022,Connecticut,3590886,202,35385,1843,291
1/18/2022,Connecticut,3590886,255,35640,1827,283
1/19/2022,Connecticut,3590886,246,35886,1796,274
1/20/2022,Connecticut,3590886,257,36143,1761,273
1/21/2022,Connecticut,3590886,233,36376,1692,258
1/22/2022,Connecticut,3590886,190,36566,1555,230
1/23/2022,Connecticut,3590886,170,36736,1510,218
1/24/2022,Connecticut,3590886,125,36861,1466,225
1/25/2022,Connecticut,3590886,167,37028,1361,210
1/26/2022,Connecticut,3590886,193,37221,1312,201
1/27/2022,Connecticut,3590886,189,37410,1239,190
1/28/2022,Connecticut,3590886,159,37569,1190,176
1/29/2022,Connecticut,3590886,170,37739,1088,172
1/30/2022,Connecticut,3590886,93,37832,1091,181
1/31/2022,Connecticut,3590886,95,37927,1009,157
2/1/2022,Connecticut,3590886,120,38047,951,150
2/2/2022,Connecticut,3590886,141,38188,893,131
2/3/2022,Connecticut,3590886,106,38294,803,111
2/4/2022,Connecticut,3590886,117,38411,749,110
2/5/2022,Connecticut,3590886,92,38503,697,99
2/6/2022,Connecticut,3590886,75,38578,642,95
2/7/2022,Connecticut,3590886,51,38629,607,114
2/8/2022,Connecticut,3590886,74,38703,561,92
2/9/2022,Connecticut,3590886,74,38777,561,92
7/1/2021,District of Columbia,705749,4,6306,31,8
7/2/2021,District of Columbia,705749,9,6315,37,9
7/3/2021,District of Columbia,705749,7,6322,39,10
7/4/2021,District of Columbia,705749,1,6323,33,8
7/5/2021,District of Columbia,705749,1,6324,32,9
7/6/2021,District of Columbia,705749,4,6328,31,8
7/7/2021,District of Columbia,705749,4,6332,27,6
7/8/2021,District of Columbia,705749,1,6333,26,6
7/9/2021,District of Columbia,705749,1,6334,22,3
7/10/2021,District of Columbia,705749,1,6335,20,2
7/11/2021,District of Columbia,705749,3,6338,20,2
7/12/2021,District of Columbia,705749,0,6338,18,3
7/13/2021,District of Columbia,705749,5,6343,22,4
7/14/2021,District of Columbia,705749,5,6348,25,5
7/15/2021,District of Columbia,705749,7,6355,27,7
7/16/2021,District of Columbia,705749,3,6358,25,6
7/17/2021,District of Columbia,705749,2,6360,21,5
7/18/2021,District of Columbia,705749,1,6361,22,3
7/19/2021,District of Columbia,705749,2,6363,27,4
7/20/2021,District of Columbia,705749,4,6367,23,5
7/21/2021,District of Columbia,705749,5,6372,28,5
7/22/2021,District of Columbia,705749,3,6375,26,6
7/23/2021,District of Columbia,705749,6,6381,28,6
7/24/2021,District of Columbia,705749,0,6381,28,5
7/25/2021,District of Columbia,705749,2,6383,27,6
7/26/2021,District of Columbia,705749,3,6386,27,7
7/27/2021,District of Columbia,705749,5,6391,30,8
7/28/2021,District of Columbia,705749,3,6394,27,9
7/29/2021,District of Columbia,705749,1,6395,25,9
7/30/2021,District of Columbia,705749,4,6399,28,10
7/31/2021,District of Columbia,705749,7,6406,34,11
8/1/2021,District of Columbia,705749,5,6411,36,10
8/2/2021,District of Columbia,705749,5,6416,37,10
8/3/2021,District of Columbia,705749,5,6421,41,11
8/4/2021,District of Columbia,705749,4,6425,42,11
8/5/2021,District of Columbia,705749,7,6432,44,12
8/6/2021,District of Columbia,705749,14,6446,56,11
8/7/2021,District of Columbia,705749,7,6453,56,12
8/8/2021,District of Columbia,705749,5,6458,56,13
8/9/2021,District of Columbia,705749,11,6469,61,19
8/10/2021,District of Columbia,705749,17,6486,70,21
8/11/2021,District of Columbia,705749,12,6498,69,21
8/12/2021,District of Columbia,705749,15,6513,80,22
8/13/2021,District of Columbia,705749,14,6527,79,23
8/14/2021,District of Columbia,705749,14,6541,82,24
8/15/2021,District of Columbia,705749,17,6558,83,26
8/16/2021,District of Columbia,705749,17,6575,93,26
8/17/2021,District of Columbia,705749,14,6589,97,25
8/18/2021,District of Columbia,705749,16,6605,99,25
8/19/2021,District of Columbia,705749,91,6696,101,25
8/20/2021,District of Columbia,705749,16,6712,106,24
8/21/2021,District of Columbia,705749,14,6726,107,28
8/22/2021,District of Columbia,705749,21,6747,113,30
8/23/2021,District of Columbia,705749,22,6769,127,33
8/24/2021,District of Columbia,705749,23,6792,137,32
8/25/2021,District of Columbia,705749,17,6809,130,25
8/26/2021,District of Columbia,705749,17,6826,126,29
8/27/2021,District of Columbia,705749,17,6843,120,24
8/28/2021,District of Columbia,705749,21,6864,115,25
8/29/2021,District of Columbia,705749,9,6873,110,22
8/30/2021,District of Columbia,705749,13,6886,111,24
8/31/2021,District of Columbia,705749,15,6901,106,25
9/1/2021,District of Columbia,705749,15,6916,108,26
9/2/2021,District of Columbia,705749,14,6930,113,22
9/3/2021,District of Columbia,705749,11,6941,104,21
9/4/2021,District of Columbia,705749,18,6959,105,22
9/5/2021,District of Columbia,705749,18,6977,105,22
9/6/2021,District of Columbia,705749,15,6992,111,20
9/7/2021,District of Columbia,705749,19,7011,120,21
9/8/2021,District of Columbia,705749,23,7034,127,31
9/9/2021,District of Columbia,705749,25,7059,130,25
9/10/2021,District of Columbia,705749,22,7081,132,22
9/11/2021,District of Columbia,705749,21,7102,129,25
9/12/2021,District of Columbia,705749,10,7112,128,26
9/13/2021,District of Columbia,705749,10,7122,127,24
9/14/2021,District of Columbia,705749,13,7135,122,26
9/15/2021,District of Columbia,705749,14,7149,126,23
9/16/2021,District of Columbia,705749,16,7165,129,24
9/17/2021,District of Columbia,705749,20,7185,127,20
9/18/2021,District of Columbia,705749,17,7202,124,18
9/19/2021,District of Columbia,705749,20,7222,124,15
9/20/2021,District of Columbia,705749,16,7238,128,17
9/21/2021,District of Columbia,705749,16,7254,123,19
9/22/2021,District of Columbia,705749,11,7265,125,22
9/23/2021,District of Columbia,705749,15,7280,128,21
9/24/2021,District of Columbia,705749,13,7293,120,21
9/25/2021,District of Columbia,705749,12,7305,110,19
9/26/2021,District of Columbia,705749,17,7322,110,20
9/27/2021,District of Columbia,705749,12,7334,105,21
9/28/2021,District of Columbia,705749,13,7347,105,26
9/29/2021,District of Columbia,705749,13,7360,108,23
9/30/2021,District of Columbia,705749,11,7371,109,20
10/1/2021,District of Columbia,705749,14,7385,109,18
10/2/2021,District of Columbia,705749,12,7397,110,16
10/3/2021,District of Columbia,705749,8,7405,101,16
10/4/2021,District of Columbia,705749,12,7417,102,16
10/5/2021,District of Columbia,705749,12,7429,96,14
10/6/2021,District of Columbia,705749,11,7440,97,12
10/7/2021,District of Columbia,705749,15,7455,90,13
10/8/2021,District of Columbia,705749,13,7468,95,14
10/9/2021,District of Columbia,705749,8,7476,94,17
10/10/2021,District of Columbia,705749,10,7486,88,15
10/11/2021,District of Columbia,705749,9,7495,91,19
10/12/2021,District of Columbia,705749,9,7504,87,18
10/13/2021,District of Columbia,705749,6,7510,80,17
10/14/2021,District of Columbia,705749,8,7518,82,11
10/15/2021,District of Columbia,705749,8,7526,74,16
10/16/2021,District of Columbia,705749,17,7543,79,16
10/17/2021,District of Columbia,705749,6,7549,77,14
10/18/2021,District of Columbia,705749,7,7556,78,14
10/19/2021,District of Columbia,705749,8,7564,79,15
10/20/2021,District of Columbia,705749,7,7571,70,15
10/21/2021,District of Columbia,705749,9,7580,73,17
10/22/2021,District of Columbia,705749,4,7584,69,17
10/23/2021,District of Columbia,705749,6,7590,65,16
10/24/2021,District of Columbia,705749,5,7595,63,15
10/25/2021,District of Columbia,705749,4,7599,63,14
10/26/2021,District of Columbia,705749,10,7609,66,15
10/27/2021,District of Columbia,705749,11,7620,63,14
10/28/2021,District of Columbia,705749,2,7622,59,14
10/29/2021,District of Columbia,705749,6,7628,58,16
10/30/2021,District of Columbia,705749,11,7639,59,18
10/31/2021,District of Columbia,705749,3,7642,53,17
11/1/2021,District of Columbia,705749,4,7646,52,16
11/2/2021,District of Columbia,705749,1,7647,51,16
11/3/2021,District of Columbia,705749,5,7652,51,15
11/4/2021,District of Columbia,705749,8,7660,48,15
11/5/2021,District of Columbia,705749,4,7664,48,14
11/6/2021,District of Columbia,705749,5,7669,50,16
11/7/2021,District of Columbia,705749,9,7678,60,16
11/8/2021,District of Columbia,705749,6,7684,54,14
11/9/2021,District of Columbia,705749,5,7689,56,15
11/10/2021,District of Columbia,705749,4,7693,50,14
11/11/2021,District of Columbia,705749,4,7697,48,13
11/12/2021,District of Columbia,705749,6,7703,49,12
11/13/2021,District of Columbia,705749,6,7709,51,11
11/14/2021,District of Columbia,705749,3,7712,46,11
11/15/2021,District of Columbia,705749,3,7715,50,11
11/16/2021,District of Columbia,705749,11,7726,57,12
11/17/2021,District of Columbia,705749,5,7731,54,12
11/18/2021,District of Columbia,705749,7,7738,55,18
11/19/2021,District of Columbia,705749,8,7746,58,16
11/20/2021,District of Columbia,705749,10,7756,60,16
11/21/2021,District of Columbia,705749,4,7760,61,16
11/22/2021,District of Columbia,705749,5,7765,65,14
11/23/2021,District of Columbia,705749,11,7776,64,15
11/24/2021,District of Columbia,705749,5,7781,57,13
11/25/2021,District of Columbia,705749,8,7789,55,14
11/26/2021,District of Columbia,705749,6,7795,61,14
11/27/2021,District of Columbia,705749,8,7803,68,15
11/28/2021,District of Columbia,705749,8,7811,72,15
11/29/2021,District of Columbia,705749,9,7820,72,17
11/30/2021,District of Columbia,705749,10,7830,73,14
12/1/2021,District of Columbia,705749,8,7838,74,16
12/2/2021,District of Columbia,705749,13,7851,81,18
12/3/2021,District of Columbia,705749,12,7863,87,16
12/4/2021,District of Columbia,705749,9,7872,90,14
12/5/2021,District of Columbia,705749,20,7892,103,18
12/6/2021,District of Columbia,705749,5,7897,103,16
12/7/2021,District of Columbia,705749,17,7914,111,22
12/8/2021,District of Columbia,705749,15,7929,112,20
12/9/2021,District of Columbia,705749,17,7946,110,18
12/10/2021,District of Columbia,705749,12,7958,109,17
12/11/2021,District of Columbia,705749,11,7969,110,20
12/12/2021,District of Columbia,705749,18,7987,110,17
12/13/2021,District of Columbia,705749,17,8004,113,19
12/14/2021,District of Columbia,705749,21,8025,123,23
12/15/2021,District of Columbia,705749,17,8042,131,22
12/16/2021,District of Columbia,705749,29,8071,144,22
12/17/2021,District of Columbia,705749,23,8094,154,23
12/18/2021,District of Columbia,705749,21,8115,152,25
12/19/2021,District of Columbia,705749,25,8140,159,24
12/20/2021,District of Columbia,705749,34,8174,179,25
12/21/2021,District of Columbia,705749,28,8202,189,24
12/22/2021,District of Columbia,705749,42,8244,211,24
12/23/2021,District of Columbia,705749,43,8287,221,24
12/24/2021,District of Columbia,705749,53,8340,252,32
12/25/2021,District of Columbia,705749,56,8396,279,33
12/26/2021,District of Columbia,705749,55,8451,328,43
12/27/2021,District of Columbia,705749,71,8522,386,50
12/28/2021,District of Columbia,705749,85,8607,472,54
12/29/2021,District of Columbia,705749,102,8709,530,58
12/30/2021,District of Columbia,705749,101,8810,571,62
12/31/2021,District of Columbia,705749,94,8904,607,68
1/1/2022,District of Columbia,705749,95,8999,627,65
1/2/2022,District of Columbia,705749,85,9084,678,72
1/3/2022,District of Columbia,705749,86,9170,735,80
1/4/2022,District of Columbia,705749,79,9249,753,87
1/5/2022,District of Columbia,705749,71,9320,769,88
1/6/2022,District of Columbia,705749,115,9435,815,89
1/7/2022,District of Columbia,705749,90,9525,847,97
1/8/2022,District of Columbia,705749,75,9600,812,98
1/9/2022,District of Columbia,705749,89,9689,838,102
1/10/2022,District of Columbia,705749,92,9781,871,106
1/11/2022,District of Columbia,705749,91,9872,865,115
1/12/2022,District of Columbia,705749,92,9964,864,116
1/13/2022,District of Columbia,705749,72,10036,844,115
1/14/2022,District of Columbia,705749,76,10112,809,116
1/15/2022,District of Columbia,705749,83,10195,780,114
1/16/2022,District of Columbia,705749,48,10243,759,107
1/17/2022,District of Columbia,705749,39,10282,732,109
1/18/2022,District of Columbia,705749,47,10329,719,106
1/19/2022,District of Columbia,705749,47,10376,727,110
1/20/2022,District of Columbia,705749,47,10423,668,105
1/21/2022,District of Columbia,705749,55,10478,640,97
1/22/2022,District of Columbia,705749,47,10525,579,95
1/23/2022,District of Columbia,705749,38,10563,547,85
1/24/2022,District of Columbia,705749,29,10592,543,77
1/25/2022,District of Columbia,705749,39,10631,523,73
1/26/2022,District of Columbia,705749,37,10668,526,78
1/27/2022,District of Columbia,705749,35,10703,514,76
1/28/2022,District of Columbia,705749,32,10735,485,75
1/29/2022,District of Columbia,705749,40,10775,475,65
1/30/2022,District of Columbia,705749,25,10800,454,68
1/31/2022,District of Columbia,705749,9,10809,450,66
2/1/2022,District of Columbia,705749,12,10821,412,64
2/2/2022,District of Columbia,705749,19,10840,402,61
2/3/2022,District of Columbia,705749,33,10873,384,61
2/4/2022,District of Columbia,705749,23,10896,360,58
2/5/2022,District of Columbia,705749,21,10917,321,56
2/6/2022,District of Columbia,705749,12,10929,327,58
2/7/2022,District of Columbia,705749,11,10940,317,56
2/8/2022,District of Columbia,705749,18,10958,305,52
2/9/2022,District of Columbia,705749,18,10976,305,52
7/1/2021,Delaware,945934,3,6743,23,3
7/2/2021,Delaware,945934,1,6744,19,3
7/3/2021,Delaware,945934,1,6745,14,2
7/4/2021,Delaware,945934,2,6747,17,4
7/5/2021,Delaware,945934,2,6749,17,4
7/6/2021,Delaware,945934,0,6749,22,4
7/7/2021,Delaware,945934,5,6754,21,6
7/8/2021,Delaware,945934,5,6759,22,7
7/9/2021,Delaware,945934,2,6761,22,6
7/10/2021,Delaware,945934,4,6765,20,6
7/11/2021,Delaware,945934,3,6768,18,6
7/12/2021,Delaware,945934,1,6769,17,5
7/13/2021,Delaware,945934,0,6769,19,4
7/14/2021,Delaware,945934,4,6773,23,4
7/15/2021,Delaware,945934,2,6775,22,4
7/16/2021,Delaware,945934,4,6779,23,3
7/17/2021,Delaware,945934,4,6783,30,4
7/18/2021,Delaware,945934,5,6788,29,5
7/19/2021,Delaware,945934,6,6794,31,4
7/20/2021,Delaware,945934,2,6796,29,5
7/21/2021,Delaware,945934,0,6796,25,4
7/22/2021,Delaware,945934,4,6800,27,3
7/23/2021,Delaware,945934,6,6806,32,5
7/24/2021,Delaware,945934,3,6809,30,5
7/25/2021,Delaware,945934,4,6813,35,5
7/26/2021,Delaware,945934,0,6813,30,5
7/27/2021,Delaware,945934,2,6815,32,7
7/28/2021,Delaware,945934,2,6817,46,5
7/29/2021,Delaware,945934,3,6820,40,5
7/30/2021,Delaware,945934,2,6822,41,4
7/31/2021,Delaware,945934,4,6826,42,5
8/1/2021,Delaware,945934,4,6830,55,6
8/2/2021,Delaware,945934,7,6837,44,8
8/3/2021,Delaware,945934,8,6845,52,8
8/4/2021,Delaware,945934,13,6858,70,8
8/5/2021,Delaware,945934,13,6871,81,8
8/6/2021,Delaware,945934,9,6880,89,7
8/7/2021,Delaware,945934,11,6891,93,7
8/8/2021,Delaware,945934,11,6902,102,9
8/9/2021,Delaware,945934,14,6916,96,5
8/10/2021,Delaware,945934,19,6935,111,7
8/11/2021,Delaware,945934,15,6950,112,7
8/12/2021,Delaware,945934,12,6962,113,9
8/13/2021,Delaware,945934,19,6981,118,14
8/14/2021,Delaware,945934,17,6998,142,16
8/15/2021,Delaware,945934,15,7013,129,18
8/16/2021,Delaware,945934,26,7039,140,18
8/17/2021,Delaware,945934,20,7059,152,24
8/18/2021,Delaware,945934,39,7098,165,28
8/19/2021,Delaware,945934,31,7129,171,26
8/20/2021,Delaware,945934,20,7149,180,26
8/21/2021,Delaware,945934,23,7172,183,29
8/22/2021,Delaware,945934,18,7190,186,33
8/23/2021,Delaware,945934,19,7209,188,33
8/24/2021,Delaware,945934,26,7235,202,29
8/25/2021,Delaware,945934,22,7257,208,32
8/26/2021,Delaware,945934,24,7281,225,31
8/27/2021,Delaware,945934,30,7311,227,30
8/28/2021,Delaware,945934,35,7346,222,33
8/29/2021,Delaware,945934,41,7387,232,36
8/30/2021,Delaware,945934,22,7409,225,40
8/31/2021,Delaware,945934,33,7442,234,41
9/1/2021,Delaware,945934,25,7467,237,41
9/2/2021,Delaware,945934,25,7492,232,48
9/3/2021,Delaware,945934,22,7514,241,42
9/4/2021,Delaware,945934,26,7540,235,40
9/5/2021,Delaware,945934,22,7562,231,32
9/6/2021,Delaware,945934,25,7587,226,36
9/7/2021,Delaware,945934,21,7608,232,42
9/8/2021,Delaware,945934,30,7638,256,37
9/9/2021,Delaware,945934,28,7666,250,38
9/10/2021,Delaware,945934,41,7707,258,37
9/11/2021,Delaware,945934,37,7744,263,39
9/12/2021,Delaware,945934,32,7776,270,37
9/13/2021,Delaware,945934,33,7809,271,40
9/14/2021,Delaware,945934,20,7829,258,38
9/15/2021,Delaware,945934,23,7852,251,37
9/16/2021,Delaware,945934,28,7880,251,40
9/17/2021,Delaware,945934,28,7908,243,41
9/18/2021,Delaware,945934,39,7947,246,40
9/19/2021,Delaware,945934,18,7965,222,39
9/20/2021,Delaware,945934,28,7993,226,40
9/21/2021,Delaware,945934,26,8019,237,39
9/22/2021,Delaware,945934,28,8047,223,38
9/23/2021,Delaware,945934,29,8076,223,35
9/24/2021,Delaware,945934,39,8115,214,31
9/25/2021,Delaware,945934,24,8139,215,30
9/26/2021,Delaware,945934,26,8165,205,34
9/27/2021,Delaware,945934,29,8194,217,37
9/28/2021,Delaware,945934,23,8217,215,38
9/29/2021,Delaware,945934,31,8248,223,35
9/30/2021,Delaware,945934,29,8277,223,30
10/1/2021,Delaware,945934,26,8303,217,29
10/2/2021,Delaware,945934,22,8325,214,32
10/3/2021,Delaware,945934,23,8348,228,36
10/4/2021,Delaware,945934,26,8374,221,37
10/5/2021,Delaware,945934,32,8406,234,41
10/6/2021,Delaware,945934,14,8420,233,39
10/7/2021,Delaware,945934,31,8451,232,34
10/8/2021,Delaware,945934,27,8478,226,32
10/9/2021,Delaware,945934,23,8501,216,31
10/10/2021,Delaware,945934,20,8521,203,31
10/11/2021,Delaware,945934,27,8548,208,28
10/12/2021,Delaware,945934,23,8571,193,30
10/13/2021,Delaware,945934,28,8599,210,35
10/14/2021,Delaware,945934,40,8639,219,31
10/15/2021,Delaware,945934,23,8662,206,31
10/16/2021,Delaware,945934,32,8694,207,27
10/17/2021,Delaware,945934,14,8708,198,29
10/18/2021,Delaware,945934,19,8727,189,31
10/19/2021,Delaware,945934,25,8752,183,27
10/20/2021,Delaware,945934,20,8772,179,24
10/21/2021,Delaware,945934,17,8789,179,24
10/22/2021,Delaware,945934,21,8810,173,26
10/23/2021,Delaware,945934,20,8830,176,28
10/24/2021,Delaware,945934,21,8851,176,28
10/25/2021,Delaware,945934,23,8874,169,33
10/26/2021,Delaware,945934,12,8886,164,28
10/27/2021,Delaware,945934,19,8905,154,25
10/28/2021,Delaware,945934,15,8920,155,25
10/29/2021,Delaware,945934,13,8933,152,25
10/30/2021,Delaware,945934,22,8955,157,26
10/31/2021,Delaware,945934,28,8983,165,26
11/1/2021,Delaware,945934,19,9002,159,26
11/2/2021,Delaware,945934,16,9018,160,28
11/3/2021,Delaware,945934,16,9034,156,27
11/4/2021,Delaware,945934,16,9050,152,24
11/5/2021,Delaware,945934,15,9065,150,22
11/6/2021,Delaware,945934,18,9083,148,22
11/7/2021,Delaware,945934,18,9101,146,20
11/8/2021,Delaware,945934,19,9120,147,19
11/9/2021,Delaware,945934,19,9139,149,20
11/10/2021,Delaware,945934,15,9154,144,18
11/11/2021,Delaware,945934,18,9172,145,19
11/12/2021,Delaware,945934,16,9188,154,17
11/13/2021,Delaware,945934,16,9204,151,18
11/14/2021,Delaware,945934,15,9219,151,19
11/15/2021,Delaware,945934,14,9233,149,22
11/16/2021,Delaware,945934,20,9253,148,22
11/17/2021,Delaware,945934,21,9274,143,22
11/18/2021,Delaware,945934,26,9300,159,25
11/19/2021,Delaware,945934,20,9320,164,23
11/20/2021,Delaware,945934,27,9347,170,24
11/21/2021,Delaware,945934,22,9369,170,27
11/22/2021,Delaware,945934,16,9385,181,25
11/23/2021,Delaware,945934,24,9409,171,22
11/24/2021,Delaware,945934,12,9421,169,22
11/25/2021,Delaware,945934,30,9451,175,21
11/26/2021,Delaware,945934,17,9468,181,22
11/27/2021,Delaware,945934,35,9503,199,22
11/28/2021,Delaware,945934,32,9535,215,25
11/29/2021,Delaware,945934,31,9566,237,28
11/30/2021,Delaware,945934,27,9593,243,27
12/1/2021,Delaware,945934,26,9619,247,28
12/2/2021,Delaware,945934,30,9649,267,29
12/3/2021,Delaware,945934,31,9680,267,26
12/4/2021,Delaware,945934,28,9708,263,24
12/5/2021,Delaware,945934,30,9738,274,26
12/6/2021,Delaware,945934,40,9778,302,33
12/7/2021,Delaware,945934,38,9816,307,32
12/8/2021,Delaware,945934,33,9849,312,30
12/9/2021,Delaware,945934,39,9888,316,33
12/10/2021,Delaware,945934,31,9919,326,26
12/11/2021,Delaware,945934,32,9951,320,27
12/12/2021,Delaware,945934,31,9982,317,33
12/13/2021,Delaware,945934,40,10022,329,41
12/14/2021,Delaware,945934,43,10065,342,42
12/15/2021,Delaware,945934,46,10111,355,42
12/16/2021,Delaware,945934,47,10158,350,44
12/17/2021,Delaware,945934,47,10205,352,47
12/18/2021,Delaware,945934,53,10258,365,47
12/19/2021,Delaware,945934,45,10303,368,47
12/20/2021,Delaware,945934,38,10341,366,48
12/21/2021,Delaware,945934,34,10375,370,49
12/22/2021,Delaware,945934,39,10414,374,44
12/23/2021,Delaware,945934,55,10469,397,47
12/24/2021,Delaware,945934,30,10499,386,47
12/25/2021,Delaware,945934,35,10534,376,47
12/26/2021,Delaware,945934,42,10576,386,50
12/27/2021,Delaware,945934,42,10618,394,50
12/28/2021,Delaware,945934,70,10688,430,48
12/29/2021,Delaware,945934,59,10747,444,46
12/30/2021,Delaware,945934,70,10817,482,52
12/31/2021,Delaware,945934,75,10892,479,57
1/1/2022,Delaware,945934,65,10957,499,61
1/2/2022,Delaware,945934,72,11029,526,65
1/3/2022,Delaware,945934,91,11120,562,66
1/4/2022,Delaware,945934,88,11208,599,64
1/5/2022,Delaware,945934,106,11314,650,66
1/6/2022,Delaware,945934,100,11414,667,61
1/7/2022,Delaware,945934,104,11518,670,61
1/8/2022,Delaware,945934,115,11633,691,64
1/9/2022,Delaware,945934,95,11728,715,68
1/10/2022,Delaware,945934,91,11819,721,74
1/11/2022,Delaware,945934,103,11922,742,75
1/12/2022,Delaware,945934,107,12029,756,70
1/13/2022,Delaware,945934,90,12119,767,70
1/14/2022,Delaware,945934,98,12217,737,67
1/15/2022,Delaware,945934,109,12326,728,68
1/16/2022,Delaware,945934,75,12401,729,69
1/17/2022,Delaware,945934,76,12477,700,74
1/18/2022,Delaware,945934,75,12552,683,72
1/19/2022,Delaware,945934,84,12636,654,70
1/20/2022,Delaware,945934,63,12699,603,67
1/21/2022,Delaware,945934,72,12771,571,59
1/22/2022,Delaware,945934,66,12837,571,54
1/23/2022,Delaware,945934,59,12896,554,55
1/24/2022,Delaware,945934,58,12954,557,52
1/25/2022,Delaware,945934,70,13024,552,50
1/26/2022,Delaware,945934,50,13074,528,49
1/27/2022,Delaware,945934,68,13142,494,45
1/28/2022,Delaware,945934,41,13183,448,39
1/29/2022,Delaware,945934,68,13251,419,35
1/30/2022,Delaware,945934,52,13303,424,40
1/31/2022,Delaware,945934,39,13342,408,42
2/1/2022,Delaware,945934,40,13382,372,37
2/2/2022,Delaware,945934,42,13424,348,37
2/3/2022,Delaware,945934,47,13471,344,31
2/4/2022,Delaware,945934,38,13509,321,31
2/5/2022,Delaware,945934,46,13555,291,30
2/6/2022,Delaware,945934,20,13575,264,20
2/7/2022,Delaware,945934,25,13600,256,19
2/8/2022,Delaware,945934,24,13624,230,24
2/9/2022,Delaware,945934,24,13648,230,24
7/1/2021,Florida,20271272,302,192128,1877,424
7/2/2021,Florida,20271272,343,192471,1882,443
7/3/2021,Florida,20271272,311,192782,1901,462
7/4/2021,Florida,20271272,319,193101,1981,493
7/5/2021,Florida,20271272,373,193474,2073,528
7/6/2021,Florida,20271272,423,193897,2218,549
7/7/2021,Florida,20271272,450,194347,2339,566
7/8/2021,Florida,20271272,470,194817,2462,606
7/9/2021,Florida,20271272,514,195331,2579,603
7/10/2021,Florida,20271272,515,195846,2728,631
7/11/2021,Florida,20271272,488,196334,2885,655
7/12/2021,Florida,20271272,521,196855,3068,699
7/13/2021,Florida,20271272,702,197557,3268,745
7/14/2021,Florida,20271272,672,198229,3499,776
7/15/2021,Florida,20271272,712,198941,3638,805
7/16/2021,Florida,20271272,734,199675,3893,871
7/17/2021,Florida,20271272,753,200428,4072,881
7/18/2021,Florida,20271272,782,201210,4403,959
7/19/2021,Florida,20271272,911,202121,4900,1059
7/20/2021,Florida,20271272,1042,203163,5186,1132
7/21/2021,Florida,20271272,1065,204228,5650,1224
7/22/2021,Florida,20271272,1210,205438,6056,1307
7/23/2021,Florida,20271272,1229,206667,6521,1417
7/24/2021,Florida,20271272,1312,207979,6795,1493
7/25/2021,Florida,20271272,1237,209216,7393,1612
7/26/2021,Florida,20271272,1355,210571,7941,1702
7/27/2021,Florida,20271272,1520,212091,8523,1756
7/28/2021,Florida,20271272,1557,213648,8971,1843
7/29/2021,Florida,20271272,1634,215282,9374,1964
7/30/2021,Florida,20271272,1846,217128,9918,2075
7/31/2021,Florida,20271272,1782,218910,10425,2169
8/1/2021,Florida,20271272,1725,220635,10985,2288
8/2/2021,Florida,20271272,1724,222359,11621,2422
8/3/2021,Florida,20271272,2090,224449,12159,2503
8/4/2021,Florida,20271272,2092,226541,12580,2587
8/5/2021,Florida,20271272,2196,228737,13187,2743
8/6/2021,Florida,20271272,2247,230984,13684,2811
8/7/2021,Florida,20271272,2194,233178,13790,2884
8/8/2021,Florida,20271272,2018,235196,14260,2943
8/9/2021,Florida,20271272,2105,237301,14978,3111
8/10/2021,Florida,20271272,2294,239595,15166,3127
8/11/2021,Florida,20271272,2342,241937,15369,3254
8/12/2021,Florida,20271272,2339,244276,15569,3263
8/13/2021,Florida,20271272,2332,246608,15824,3338
8/14/2021,Florida,20271272,2209,248817,15813,3420
8/15/2021,Florida,20271272,2053,250870,16170,3503
8/16/2021,Florida,20271272,2137,253007,16528,3593
8/17/2021,Florida,20271272,2360,255367,16844,3673
8/18/2021,Florida,20271272,2310,257677,17048,3636
8/19/2021,Florida,20271272,2260,259937,16862,3602
8/20/2021,Florida,20271272,2275,262212,16916,3605
8/21/2021,Florida,20271272,2218,264430,16778,3591
8/22/2021,Florida,20271272,1925,266355,17000,3629
8/23/2021,Florida,20271272,1908,268263,17121,3671
8/24/2021,Florida,20271272,2088,270351,16869,3714
8/25/2021,Florida,20271272,2066,272417,16489,3713
8/26/2021,Florida,20271272,2058,274475,16258,3650
8/27/2021,Florida,20271272,1948,276423,15927,3613
8/28/2021,Florida,20271272,1869,278292,15434,3510
8/29/2021,Florida,20271272,1671,279963,15510,3559
8/30/2021,Florida,20271272,1600,281563,15457,3487
8/31/2021,Florida,20271272,1788,283351,15200,3413
9/1/2021,Florida,20271272,1837,285188,14845,3394
9/2/2021,Florida,20271272,1764,286952,14470,3325
9/3/2021,Florida,20271272,1588,288540,13914,3269
9/4/2021,Florida,20271272,1546,290086,13365,3170
9/5/2021,Florida,20271272,1420,291506,13296,3160
9/6/2021,Florida,20271272,1378,292884,13262,3140
9/7/2021,Florida,20271272,1361,294245,13030,3077
9/8/2021,Florida,20271272,1427,295672,12682,3065
9/9/2021,Florida,20271272,1403,297075,12225,2957
9/10/2021,Florida,20271272,1341,298416,11814,2902
9/11/2021,Florida,20271272,1197,299613,11093,2772
9/12/2021,Florida,20271272,1088,300701,10889,2737
9/13/2021,Florida,20271272,1011,301712,10678,2701
9/14/2021,Florida,20271272,1117,302829,10207,2602
9/15/2021,Florida,20271272,1107,303936,9786,2521
9/16/2021,Florida,20271272,1062,304998,9220,2443
9/17/2021,Florida,20271272,982,305980,8925,2389
9/18/2021,Florida,20271272,974,306954,8480,2282
9/19/2021,Florida,20271272,837,307791,8308,2249
9/20/2021,Florida,20271272,760,308551,8164,2203
9/21/2021,Florida,20271272,869,309420,7825,2118
9/22/2021,Florida,20271272,833,310253,7507,2035
9/23/2021,Florida,20271272,753,311006,7060,1930
9/24/2021,Florida,20271272,725,311731,6755,1865
9/25/2021,Florida,20271272,734,312465,6382,1779
9/26/2021,Florida,20271272,646,313111,6233,1706
9/27/2021,Florida,20271272,566,313677,6152,1675
9/28/2021,Florida,20271272,683,314360,5839,1590
9/29/2021,Florida,20271272,621,314981,5478,1516
9/30/2021,Florida,20271272,581,315562,5168,1419
10/1/2021,Florida,20271272,525,316087,4880,1357
10/2/2021,Florida,20271272,498,316585,4516,1314
10/3/2021,Florida,20271272,430,317015,4350,1262
10/4/2021,Florida,20271272,439,317454,4302,1212
10/5/2021,Florida,20271272,490,317944,4183,1187
10/6/2021,Florida,20271272,545,318489,4030,1133
10/7/2021,Florida,20271272,467,318956,3836,1089
10/8/2021,Florida,20271272,465,319421,3630,1073
10/9/2021,Florida,20271272,397,319818,3405,997
10/10/2021,Florida,20271272,358,320176,3302,980
10/11/2021,Florida,20271272,339,320515,3282,955
10/12/2021,Florida,20271272,412,320927,3153,913
10/13/2021,Florida,20271272,405,321332,3061,913
10/14/2021,Florida,20271272,367,321699,2929,889
10/15/2021,Florida,20271272,358,322057,2779,821
10/16/2021,Florida,20271272,318,322375,2676,803
10/17/2021,Florida,20271272,265,322640,2584,784
10/18/2021,Florida,20271272,276,322916,2547,760
10/19/2021,Florida,20271272,341,323257,2438,728
10/20/2021,Florida,20271272,301,323558,2328,661
10/21/2021,Florida,20271272,302,323860,2249,624
10/22/2021,Florida,20271272,292,324152,2139,608
10/23/2021,Florida,20271272,281,324433,2042,599
10/24/2021,Florida,20271272,219,324652,2015,579
10/25/2021,Florida,20271272,230,324882,2022,571
10/26/2021,Florida,20271272,270,325152,1943,572
10/27/2021,Florida,20271272,267,325419,1909,540
10/28/2021,Florida,20271272,249,325668,1855,519
10/29/2021,Florida,20271272,228,325896,1776,489
10/30/2021,Florida,20271272,210,326106,1654,476
10/31/2021,Florida,20271272,182,326288,1623,466
11/1/2021,Florida,20271272,188,326476,1591,454
11/2/2021,Florida,20271272,216,326692,1542,421
11/3/2021,Florida,20271272,233,326925,1510,414
11/4/2021,Florida,20271272,204,327129,1414,397
11/5/2021,Florida,20271272,197,327326,1370,375
11/6/2021,Florida,20271272,206,327532,1338,352
11/7/2021,Florida,20271272,178,327710,1336,356
11/8/2021,Florida,20271272,195,327905,1329,351
11/9/2021,Florida,20271272,194,328099,1268,346
11/10/2021,Florida,20271272,211,328310,1218,330
11/11/2021,Florida,20271272,198,328508,1194,313
11/12/2021,Florida,20271272,172,328680,1155,305
11/13/2021,Florida,20271272,157,328837,1102,300
11/14/2021,Florida,20271272,149,328986,1056,286
11/15/2021,Florida,20271272,164,329150,1083,287
11/16/2021,Florida,20271272,209,329359,1112,282
11/17/2021,Florida,20271272,209,329568,1096,285
11/18/2021,Florida,20271272,191,329759,1108,267
11/19/2021,Florida,20271272,182,329941,1104,255
11/20/2021,Florida,20271272,199,330140,1109,257
11/21/2021,Florida,20271272,152,330292,1098,259
11/22/2021,Florida,20271272,172,330464,1122,259
11/23/2021,Florida,20271272,194,330658,1088,254
11/24/2021,Florida,20271272,182,330840,1037,253
11/25/2021,Florida,20271272,152,330992,982,243
11/26/2021,Florida,20271272,137,331129,987,248
11/27/2021,Florida,20271272,185,331314,1004,244
11/28/2021,Florida,20271272,150,331464,1007,244
11/29/2021,Florida,20271272,180,331644,1039,254
11/30/2021,Florida,20271272,193,331837,1025,241
12/1/2021,Florida,20271272,165,332002,994,239
12/2/2021,Florida,20271272,176,332178,995,259
12/3/2021,Florida,20271272,206,332384,988,262
12/4/2021,Florida,20271272,177,332561,977,250
12/5/2021,Florida,20271272,163,332724,1026,258
12/6/2021,Florida,20271272,180,332904,1072,265
12/7/2021,Florida,20271272,221,333125,1141,249
12/8/2021,Florida,20271272,211,333336,1113,250
12/9/2021,Florida,20271272,194,333530,1087,255
12/10/2021,Florida,20271272,192,333722,1101,248
12/11/2021,Florida,20271272,207,333929,1088,262
12/12/2021,Florida,20271272,187,334116,1118,283
12/13/2021,Florida,20271272,165,334281,1181,280
12/14/2021,Florida,20271272,277,334558,1231,281
12/15/2021,Florida,20271272,216,334774,1213,276
12/16/2021,Florida,20271272,238,335012,1195,276
12/17/2021,Florida,20271272,257,335269,1209,283
12/18/2021,Florida,20271272,313,335582,1258,280
12/19/2021,Florida,20271272,298,335880,1321,279
12/20/2021,Florida,20271272,317,336197,1411,288
12/21/2021,Florida,20271272,439,336636,1541,301
12/22/2021,Florida,20271272,480,337116,1697,307
12/23/2021,Florida,20271272,541,337657,1917,330
12/24/2021,Florida,20271272,529,338186,2034,337
12/25/2021,Florida,20271272,586,338772,2180,356
12/26/2021,Florida,20271272,636,339408,2456,375
12/27/2021,Florida,20271272,794,340202,2915,405
12/28/2021,Florida,20271272,1089,341291,3511,457
12/29/2021,Florida,20271272,1276,342567,4199,499
12/30/2021,Florida,20271272,1366,343933,4766,549
12/31/2021,Florida,20271272,1349,345282,5165,593
1/1/2022,Florida,20271272,1379,346661,5495,667
1/2/2022,Florida,20271272,1511,348172,6166,741
1/3/2022,Florida,20271272,1627,349799,6941,820
1/4/2022,Florida,20271272,1936,351735,7692,898
1/5/2022,Florida,20271272,2055,353790,8321,986
1/6/2022,Florida,20271272,1983,355773,8893,1062
1/7/2022,Florida,20271272,2067,357840,9386,1168
1/8/2022,Florida,20271272,2027,359867,9620,1216
1/9/2022,Florida,20271272,2013,361880,10436,1336
1/10/2022,Florida,20271272,1949,363829,10954,1398
1/11/2022,Florida,20271272,2138,365967,11133,1432
1/12/2022,Florida,20271272,2216,368183,11334,1478
1/13/2022,Florida,20271272,2113,370296,11276,1481
1/14/2022,Florida,20271272,2187,372483,11362,1521
1/15/2022,Florida,20271272,2040,374523,11251,1539
1/16/2022,Florida,20271272,1831,376354,11264,1564
1/17/2022,Florida,20271272,1774,378128,11493,1616
1/18/2022,Florida,20271272,1999,380127,11509,1612
1/19/2022,Florida,20271272,1969,382096,11346,1631
1/20/2022,Florida,20271272,1938,384034,11110,1618
1/21/2022,Florida,20271272,1817,385851,10962,1630
1/22/2022,Florida,20271272,1821,387672,10602,1604
1/23/2022,Florida,20271272,1537,389209,10502,1600
1/24/2022,Florida,20271272,1424,390633,10452,1571
1/25/2022,Florida,20271272,1655,392288,10249,1540
1/26/2022,Florida,20271272,1600,393888,9955,1489
1/27/2022,Florida,20271272,1645,395533,9473,1470
1/28/2022,Florida,20271272,1466,396999,9279,1452
1/29/2022,Florida,20271272,1448,398447,8842,1424
1/30/2022,Florida,20271272,1255,399702,8700,1367
1/31/2022,Florida,20271272,1124,400826,8684,1350
2/1/2022,Florida,20271272,1343,402169,8355,1331
2/2/2022,Florida,20271272,1236,403405,8041,1300
2/3/2022,Florida,20271272,1250,404655,7749,1251
2/4/2022,Florida,20271272,1142,405797,7387,1193
2/5/2022,Florida,20271272,1093,406890,6980,1120
2/6/2022,Florida,20271272,919,407809,6915,1143
2/7/2022,Florida,20271272,891,408700,6967,1138
2/8/2022,Florida,20271272,949,409649,6728,1108
2/9/2022,Florida,20271272,949,410598,6728,1108
7/1/2021,Georgia,10214860,101,111823,365,103
7/2/2021,Georgia,10214860,87,111910,365,107
7/3/2021,Georgia,10214860,94,112004,364,103
7/4/2021,Georgia,10214860,75,112079,365,97
7/5/2021,Georgia,10214860,70,112149,390,106
7/6/2021,Georgia,10214860,101,112250,431,99
7/7/2021,Georgia,10214860,118,112368,445,114
7/8/2021,Georgia,10214860,112,112480,465,129
7/9/2021,Georgia,10214860,137,112617,502,135
7/10/2021,Georgia,10214860,116,112733,526,145
7/11/2021,Georgia,10214860,121,112854,530,161
7/12/2021,Georgia,10214860,114,112968,593,165
7/13/2021,Georgia,10214860,141,113109,656,175
7/14/2021,Georgia,10214860,141,113250,694,178
7/15/2021,Georgia,10214860,145,113395,706,190
7/16/2021,Georgia,10214860,146,113541,746,196
7/17/2021,Georgia,10214860,166,113707,773,203
7/18/2021,Georgia,10214860,158,113865,821,215
7/19/2021,Georgia,10214860,139,114004,871,243
7/20/2021,Georgia,10214860,195,114199,928,262
7/21/2021,Georgia,10214860,207,114406,998,286
7/22/2021,Georgia,10214860,213,114619,1066,296
7/23/2021,Georgia,10214860,262,114881,1162,310
7/24/2021,Georgia,10214860,270,115151,1256,326
7/25/2021,Georgia,10214860,256,115407,1333,351
7/26/2021,Georgia,10214860,263,115670,1431,361
7/27/2021,Georgia,10214860,297,115967,1539,398
7/28/2021,Georgia,10214860,362,116329,1684,449
7/29/2021,Georgia,10214860,391,116720,1839,477
7/30/2021,Georgia,10214860,446,117166,2052,536
7/31/2021,Georgia,10214860,440,117606,2200,587
8/1/2021,Georgia,10214860,377,117983,2342,588
8/2/2021,Georgia,10214860,339,118322,2533,651
8/3/2021,Georgia,10214860,506,118828,2722,661
8/4/2021,Georgia,10214860,547,119375,2921,722
8/5/2021,Georgia,10214860,539,119914,3065,747
8/6/2021,Georgia,10214860,535,120449,3194,768
8/7/2021,Georgia,10214860,582,121031,3326,806
8/8/2021,Georgia,10214860,529,121560,3476,850
8/9/2021,Georgia,10214860,497,122057,3644,905
8/10/2021,Georgia,10214860,625,122682,3794,959
8/11/2021,Georgia,10214860,703,123385,3989,1042
8/12/2021,Georgia,10214860,655,124040,4054,1037
8/13/2021,Georgia,10214860,770,124810,4251,1135
8/14/2021,Georgia,10214860,685,125495,4431,1163
8/15/2021,Georgia,10214860,584,126079,4556,1189
8/16/2021,Georgia,10214860,612,126691,4653,1176
8/17/2021,Georgia,10214860,708,127399,4882,1270
8/18/2021,Georgia,10214860,764,128163,4975,1236
8/19/2021,Georgia,10214860,788,128951,5239,1299
8/20/2021,Georgia,10214860,738,129689,5308,1324
8/21/2021,Georgia,10214860,737,130426,5348,1404
8/22/2021,Georgia,10214860,724,131150,5378,1401
8/23/2021,Georgia,10214860,691,131841,5572,1420
8/24/2021,Georgia,10214860,841,132682,5706,1438
8/25/2021,Georgia,10214860,922,133604,5823,1425
8/26/2021,Georgia,10214860,907,134511,5863,1432
8/27/2021,Georgia,10214860,829,135340,5881,1451
8/28/2021,Georgia,10214860,800,136140,5902,1486
8/29/2021,Georgia,10214860,684,136824,5956,1503
8/30/2021,Georgia,10214860,671,137495,5976,1494
8/31/2021,Georgia,10214860,762,138257,6050,1507
9/1/2021,Georgia,10214860,800,139057,6111,1501
9/2/2021,Georgia,10214860,800,139857,6142,1514
9/3/2021,Georgia,10214860,761,140618,6093,1482
9/4/2021,Georgia,10214860,750,141368,6001,1489
9/5/2021,Georgia,10214860,653,142021,5926,1479
9/6/2021,Georgia,10214860,681,142702,6041,1534
9/7/2021,Georgia,10214860,687,143389,6076,1562
9/8/2021,Georgia,10214860,731,144120,6029,1607
9/9/2021,Georgia,10214860,696,144816,5917,1594
9/10/2021,Georgia,10214860,701,145517,5885,1648
9/11/2021,Georgia,10214860,624,146141,5535,1589
9/12/2021,Georgia,10214860,554,146695,5475,1584
9/13/2021,Georgia,10214860,494,147189,5564,1583
9/14/2021,Georgia,10214860,556,147745,5437,1571
9/15/2021,Georgia,10214860,625,148370,5401,1530
9/16/2021,Georgia,10214860,607,148977,5258,1515
9/17/2021,Georgia,10214860,527,149504,5114,1497
9/18/2021,Georgia,10214860,501,150005,4892,1425
9/19/2021,Georgia,10214860,400,150405,4560,1364
9/20/2021,Georgia,10214860,363,150768,4639,1388
9/21/2021,Georgia,10214860,490,151258,4548,1392
9/22/2021,Georgia,10214860,518,151776,4269,1313
9/23/2021,Georgia,10214860,508,152284,4081,1268
9/24/2021,Georgia,10214860,427,152711,3939,1214
9/25/2021,Georgia,10214860,408,153119,3724,1195
9/26/2021,Georgia,10214860,408,153527,3662,1192
9/27/2021,Georgia,10214860,317,153844,3630,1180
9/28/2021,Georgia,10214860,378,154222,3536,1158
9/29/2021,Georgia,10214860,411,154633,3387,1108
9/30/2021,Georgia,10214860,431,155064,3250,1047
10/1/2021,Georgia,10214860,403,155467,3133,1042
10/2/2021,Georgia,10214860,370,155837,2985,1014
10/3/2021,Georgia,10214860,337,156174,2904,984
10/4/2021,Georgia,10214860,271,156445,2894,979
10/5/2021,Georgia,10214860,304,156749,2756,925
10/6/2021,Georgia,10214860,404,157153,2715,885
10/7/2021,Georgia,10214860,362,157515,2615,843
10/8/2021,Georgia,10214860,373,157888,2555,821
10/9/2021,Georgia,10214860,325,158213,2458,794
10/10/2021,Georgia,10214860,332,158545,2421,792
10/11/2021,Georgia,10214860,251,158796,2393,787
10/12/2021,Georgia,10214860,242,159038,2211,724
10/13/2021,Georgia,10214860,296,159334,2113,688
10/14/2021,Georgia,10214860,289,159623,2004,666
10/15/2021,Georgia,10214860,270,159893,1911,650
10/16/2021,Georgia,10214860,269,160162,1784,615
10/17/2021,Georgia,10214860,245,160407,1772,610
10/18/2021,Georgia,10214860,153,160560,1748,594
10/19/2021,Georgia,10214860,176,160736,1695,585
10/20/2021,Georgia,10214860,206,160942,1625,549
10/21/2021,Georgia,10214860,211,161153,1534,527
10/22/2021,Georgia,10214860,182,161335,1476,499
10/23/2021,Georgia,10214860,185,161520,1412,471
10/24/2021,Georgia,10214860,190,161710,1427,476
10/25/2021,Georgia,10214860,145,161855,1445,468
10/26/2021,Georgia,10214860,165,162020,1396,464
10/27/2021,Georgia,10214860,201,162221,1362,423
10/28/2021,Georgia,10214860,173,162394,1283,402
10/29/2021,Georgia,10214860,169,162563,1225,383
10/30/2021,Georgia,10214860,152,162715,1198,377
10/31/2021,Georgia,10214860,134,162849,1170,371
11/1/2021,Georgia,10214860,108,162957,1154,373
11/2/2021,Georgia,10214860,178,163135,1121,351
11/3/2021,Georgia,10214860,156,163291,1092,339
11/4/2021,Georgia,10214860,131,163422,1038,328
11/5/2021,Georgia,10214860,138,163560,973,314
11/6/2021,Georgia,10214860,125,163685,889,294
11/7/2021,Georgia,10214860,127,163812,902,294
11/8/2021,Georgia,10214860,104,163916,911,293
11/9/2021,Georgia,10214860,141,164057,906,287
11/10/2021,Georgia,10214860,142,164199,887,276
11/11/2021,Georgia,10214860,148,164347,848,269
11/12/2021,Georgia,10214860,141,164488,841,270
11/13/2021,Georgia,10214860,145,164633,841,256
11/14/2021,Georgia,10214860,123,164756,834,254
11/15/2021,Georgia,10214860,113,164869,862,255
11/16/2021,Georgia,10214860,138,165007,839,245
11/17/2021,Georgia,10214860,133,165140,819,241
11/18/2021,Georgia,10214860,136,165276,815,243
11/19/2021,Georgia,10214860,136,165412,792,224
11/20/2021,Georgia,10214860,142,165554,744,211
11/21/2021,Georgia,10214860,103,165657,731,213
11/22/2021,Georgia,10214860,101,165758,762,215
11/23/2021,Georgia,10214860,141,165899,771,219
11/24/2021,Georgia,10214860,109,166008,761,221
11/25/2021,Georgia,10214860,97,166105,746,227
11/26/2021,Georgia,10214860,113,166218,767,231
11/27/2021,Georgia,10214860,107,166325,795,234
11/28/2021,Georgia,10214860,101,166426,816,245
11/29/2021,Georgia,10214860,100,166526,818,240
11/30/2021,Georgia,10214860,124,166650,827,242
12/1/2021,Georgia,10214860,123,166773,819,237
12/2/2021,Georgia,10214860,138,166911,831,236
12/3/2021,Georgia,10214860,144,167055,836,222
12/4/2021,Georgia,10214860,147,167202,796,207
12/5/2021,Georgia,10214860,119,167321,839,228
12/6/2021,Georgia,10214860,110,167431,857,239
12/7/2021,Georgia,10214860,166,167597,930,248
12/8/2021,Georgia,10214860,154,167751,950,256
12/9/2021,Georgia,10214860,134,167885,957,265
12/10/2021,Georgia,10214860,168,168053,955,275
12/11/2021,Georgia,10214860,159,168212,967,283
12/12/2021,Georgia,10214860,132,168344,986,282
12/13/2021,Georgia,10214860,119,168463,998,281
12/14/2021,Georgia,10214860,176,168639,1016,277
12/15/2021,Georgia,10214860,198,168837,1017,280
12/16/2021,Georgia,10214860,162,168999,1036,307
12/17/2021,Georgia,10214860,230,169229,1067,308
12/18/2021,Georgia,10214860,233,169462,1048,306
12/19/2021,Georgia,10214860,197,169659,1084,308
12/20/2021,Georgia,10214860,189,169848,1143,316
12/21/2021,Georgia,10214860,208,170056,1204,334
12/22/2021,Georgia,10214860,287,170343,1289,328
12/23/2021,Georgia,10214860,273,170616,1321,327
12/24/2021,Georgia,10214860,316,170932,1372,324
12/25/2021,Georgia,10214860,347,171279,1489,351
12/26/2021,Georgia,10214860,368,171647,1646,363
12/27/2021,Georgia,10214860,400,172047,1944,391
12/28/2021,Georgia,10214860,493,172540,2197,378
12/29/2021,Georgia,10214860,655,173195,2604,431
12/30/2021,Georgia,10214860,684,173879,2889,463
12/31/2021,Georgia,10214860,662,174541,3093,514
1/1/2022,Georgia,10214860,616,175157,3229,550
1/2/2022,Georgia,10214860,678,175835,3554,607
1/3/2022,Georgia,10214860,679,176514,3825,655
1/4/2022,Georgia,10214860,807,177321,4140,712
1/5/2022,Georgia,10214860,918,178239,4550,724
1/6/2022,Georgia,10214860,889,179128,4679,750
1/7/2022,Georgia,10214860,877,180005,4780,767
1/8/2022,Georgia,10214860,929,180934,5004,793
1/9/2022,Georgia,10214860,827,181761,5126,817
1/10/2022,Georgia,10214860,672,182433,5207,857
1/11/2022,Georgia,10214860,858,183291,5442,900
1/12/2022,Georgia,10214860,936,184227,5630,935
1/13/2022,Georgia,10214860,871,185098,5623,946
1/14/2022,Georgia,10214860,919,186017,5671,970
1/15/2022,Georgia,10214860,881,186898,5399,937
1/16/2022,Georgia,10214860,783,187681,5588,990
1/17/2022,Georgia,10214860,568,188249,5704,1004
1/18/2022,Georgia,10214860,738,188987,5672,990
1/19/2022,Georgia,10214860,817,189804,5718,960
1/20/2022,Georgia,10214860,780,190584,5595,965
1/21/2022,Georgia,10214860,729,191313,5483,975
1/22/2022,Georgia,10214860,721,192034,5391,959
1/23/2022,Georgia,10214860,566,192600,5369,935
1/24/2022,Georgia,10214860,582,193182,5333,930
1/25/2022,Georgia,10214860,765,193947,5345,945
1/26/2022,Georgia,10214860,714,194661,5388,946
1/27/2022,Georgia,10214860,739,195400,5290,933
1/28/2022,Georgia,10214860,673,196073,5132,920
1/29/2022,Georgia,10214860,656,196729,4919,896
1/30/2022,Georgia,10214860,477,197206,4840,866
1/31/2022,Georgia,10214860,494,197700,4769,863
2/1/2022,Georgia,10214860,658,198358,4705,864
2/2/2022,Georgia,10214860,590,198948,4635,858
2/3/2022,Georgia,10214860,610,199558,4457,843
2/4/2022,Georgia,10214860,476,200034,4196,831
2/5/2022,Georgia,10214860,493,200527,4014,815
2/6/2022,Georgia,10214860,400,200927,3861,791
2/7/2022,Georgia,10214860,482,201409,3804,778
2/8/2022,Georgia,10214860,517,201926,3653,721
2/9/2022,Georgia,10214860,514,202440,3629,717
7/1/2021,Hawaii,1431603,3,4012,51,15
7/2/2021,Hawaii,1431603,6,4018,43,12
7/3/2021,Hawaii,1431603,3,4021,43,10
7/4/2021,Hawaii,1431603,2,4023,41,11
7/5/2021,Hawaii,1431603,6,4029,41,11
7/6/2021,Hawaii,1431603,15,4044,49,13
7/7/2021,Hawaii,1431603,7,4051,49,13
7/8/2021,Hawaii,1431603,8,4059,54,13
7/9/2021,Hawaii,1431603,8,4067,52,13
7/10/2021,Hawaii,1431603,6,4073,48,14
7/11/2021,Hawaii,1431603,3,4076,51,13
7/12/2021,Hawaii,1431603,6,4082,52,13
7/13/2021,Hawaii,1431603,6,4088,51,13
7/14/2021,Hawaii,1431603,3,4091,50,15
7/15/2021,Hawaii,1431603,5,4096,59,15
7/16/2021,Hawaii,1431603,5,4101,53,15
7/17/2021,Hawaii,1431603,5,4106,58,17
7/18/2021,Hawaii,1431603,7,4113,58,15
7/19/2021,Hawaii,1431603,2,4115,59,15
7/20/2021,Hawaii,1431603,10,4125,68,18
7/21/2021,Hawaii,1431603,7,4132,70,20
7/22/2021,Hawaii,1431603,10,4142,73,20
7/23/2021,Hawaii,1431603,5,4147,68,16
7/24/2021,Hawaii,1431603,6,4153,73,20
7/25/2021,Hawaii,1431603,8,4161,71,22
7/26/2021,Hawaii,1431603,15,4176,85,23
7/27/2021,Hawaii,1431603,12,4188,94,24
7/28/2021,Hawaii,1431603,9,4197,103,23
7/29/2021,Hawaii,1431603,14,4211,107,22
7/30/2021,Hawaii,1431603,17,4228,119,25
7/31/2021,Hawaii,1431603,15,4243,125,21
8/1/2021,Hawaii,1431603,18,4261,137,21
8/2/2021,Hawaii,1431603,24,4285,144,25
8/3/2021,Hawaii,1431603,22,4307,145,24
8/4/2021,Hawaii,1431603,31,4338,165,30
8/5/2021,Hawaii,1431603,29,4367,171,34
8/6/2021,Hawaii,1431603,43,4410,185,36
8/7/2021,Hawaii,1431603,42,4452,203,40
8/8/2021,Hawaii,1431603,41,4493,215,42
8/9/2021,Hawaii,1431603,30,4523,225,44
8/10/2021,Hawaii,1431603,34,4557,245,47
8/11/2021,Hawaii,1431603,55,4612,267,47
8/12/2021,Hawaii,1431603,54,4666,278,47
8/13/2021,Hawaii,1431603,48,4714,288,54
8/14/2021,Hawaii,1431603,40,4754,292,57
8/15/2021,Hawaii,1431603,42,4796,293,61
8/16/2021,Hawaii,1431603,37,4833,318,67
8/17/2021,Hawaii,1431603,67,4900,313,68
8/18/2021,Hawaii,1431603,66,4966,353,72
8/19/2021,Hawaii,1431603,56,5022,341,70
8/20/2021,Hawaii,1431603,63,5085,364,66
8/21/2021,Hawaii,1431603,58,5143,378,72
8/22/2021,Hawaii,1431603,54,5197,395,85
8/23/2021,Hawaii,1431603,62,5259,407,89
8/24/2021,Hawaii,1431603,63,5322,415,83
8/25/2021,Hawaii,1431603,56,5378,412,87
8/26/2021,Hawaii,1431603,53,5431,412,87
8/27/2021,Hawaii,1431603,52,5483,417,90
8/28/2021,Hawaii,1431603,39,5522,416,94
8/29/2021,Hawaii,1431603,36,5558,418,84
8/30/2021,Hawaii,1431603,41,5599,420,90
8/31/2021,Hawaii,1431603,50,5649,437,99
9/1/2021,Hawaii,1431603,48,5697,435,99
9/2/2021,Hawaii,1431603,35,5732,433,101
9/3/2021,Hawaii,1431603,48,5780,442,96
9/4/2021,Hawaii,1431603,41,5821,441,87
9/5/2021,Hawaii,1431603,30,5851,431,82
9/6/2021,Hawaii,1431603,43,5894,439,87
9/7/2021,Hawaii,1431603,30,5924,425,83
9/8/2021,Hawaii,1431603,42,5966,421,86
9/9/2021,Hawaii,1431603,59,6025,425,89
9/10/2021,Hawaii,1431603,38,6063,405,81
9/11/2021,Hawaii,1431603,38,6101,403,85
9/12/2021,Hawaii,1431603,36,6137,400,72
9/13/2021,Hawaii,1431603,32,6169,392,72
9/14/2021,Hawaii,1431603,33,6202,370,69
9/15/2021,Hawaii,1431603,31,6233,357,71
9/16/2021,Hawaii,1431603,40,6273,342,72
9/17/2021,Hawaii,1431603,43,6316,325,79
9/18/2021,Hawaii,1431603,25,6341,318,75
9/19/2021,Hawaii,1431603,25,6366,312,75
9/20/2021,Hawaii,1431603,26,6392,305,72
9/21/2021,Hawaii,1431603,23,6415,295,73
9/22/2021,Hawaii,1431603,19,6434,278,69
9/23/2021,Hawaii,1431603,22,6456,280,65
9/24/2021,Hawaii,1431603,28,6484,283,67
9/25/2021,Hawaii,1431603,22,6506,268,55
9/26/2021,Hawaii,1431603,19,6525,267,57
9/27/2021,Hawaii,1431603,29,6554,266,51
9/28/2021,Hawaii,1431603,21,6575,257,47
9/29/2021,Hawaii,1431603,15,6590,232,45
9/30/2021,Hawaii,1431603,18,6608,210,48
10/1/2021,Hawaii,1431603,18,6626,197,43
10/2/2021,Hawaii,1431603,16,6642,193,43
10/3/2021,Hawaii,1431603,14,6656,192,41
10/4/2021,Hawaii,1431603,14,6670,191,44
10/5/2021,Hawaii,1431603,6,6676,170,41
10/6/2021,Hawaii,1431603,16,6692,164,43
10/7/2021,Hawaii,1431603,13,6705,157,44
10/8/2021,Hawaii,1431603,16,6721,155,41
10/9/2021,Hawaii,1431603,14,6735,155,46
10/10/2021,Hawaii,1431603,17,6752,157,42
10/11/2021,Hawaii,1431603,10,6762,152,37
10/12/2021,Hawaii,1431603,7,6769,139,37
10/13/2021,Hawaii,1431603,10,6779,127,40
10/14/2021,Hawaii,1431603,7,6786,103,29
10/15/2021,Hawaii,1431603,6,6792,91,26
10/16/2021,Hawaii,1431603,11,6803,97,26
10/17/2021,Hawaii,1431603,9,6812,100,27
10/18/2021,Hawaii,1431603,7,6819,92,27
10/19/2021,Hawaii,1431603,6,6825,92,24
10/20/2021,Hawaii,1431603,6,6831,85,21
10/21/2021,Hawaii,1431603,8,6839,84,20
10/22/2021,Hawaii,1431603,11,6850,89,20
10/23/2021,Hawaii,1431603,5,6855,86,20
10/24/2021,Hawaii,1431603,6,6861,87,21
10/25/2021,Hawaii,1431603,8,6869,87,18
10/26/2021,Hawaii,1431603,15,6884,90,19
10/27/2021,Hawaii,1431603,10,6894,91,21
10/28/2021,Hawaii,1431603,8,6902,87,19
10/29/2021,Hawaii,1431603,11,6913,86,23
10/30/2021,Hawaii,1431603,6,6919,83,22
10/31/2021,Hawaii,1431603,1,6920,79,20
11/1/2021,Hawaii,1431603,6,6926,76,15
11/2/2021,Hawaii,1431603,5,6931,76,19
11/3/2021,Hawaii,1431603,7,6938,75,19
11/4/2021,Hawaii,1431603,7,6945,67,16
11/5/2021,Hawaii,1431603,5,6950,69,16
11/6/2021,Hawaii,1431603,3,6953,63,13
11/7/2021,Hawaii,1431603,5,6958,65,17
11/8/2021,Hawaii,1431603,3,6961,58,15
11/9/2021,Hawaii,1431603,7,6968,57,16
11/10/2021,Hawaii,1431603,10,6978,57,16
11/11/2021,Hawaii,1431603,2,6980,52,14
11/12/2021,Hawaii,1431603,9,6989,53,12
11/13/2021,Hawaii,1431603,6,6995,54,11
11/14/2021,Hawaii,1431603,6,7001,49,7
11/15/2021,Hawaii,1431603,4,7005,53,6
11/16/2021,Hawaii,1431603,9,7014,59,8
11/17/2021,Hawaii,1431603,5,7019,54,11
11/18/2021,Hawaii,1431603,5,7024,53,12
11/19/2021,Hawaii,1431603,6,7030,48,12
11/20/2021,Hawaii,1431603,6,7036,49,11
11/21/2021,Hawaii,1431603,0,7036,48,9
11/22/2021,Hawaii,1431603,7,7043,51,9
11/23/2021,Hawaii,1431603,7,7050,50,8
11/24/2021,Hawaii,1431603,4,7054,47,9
11/25/2021,Hawaii,1431603,5,7059,45,10
11/26/2021,Hawaii,1431603,5,7064,43,11
11/27/2021,Hawaii,1431603,6,7070,45,11
11/28/2021,Hawaii,1431603,4,7074,44,11
11/29/2021,Hawaii,1431603,6,7080,46,12
11/30/2021,Hawaii,1431603,8,7088,47,10
12/1/2021,Hawaii,1431603,5,7093,44,9
12/2/2021,Hawaii,1431603,5,7098,42,7
12/3/2021,Hawaii,1431603,0,7098,40,6
12/4/2021,Hawaii,1431603,4,7102,43,7
12/5/2021,Hawaii,1431603,5,7107,46,8
12/6/2021,Hawaii,1431603,4,7111,42,6
12/7/2021,Hawaii,1431603,1,7112,42,7
12/8/2021,Hawaii,1431603,7,7119,50,8
12/9/2021,Hawaii,1431603,3,7122,47,8
12/10/2021,Hawaii,1431603,12,7134,45,8
12/11/2021,Hawaii,1431603,3,7137,44,9
12/12/2021,Hawaii,1431603,2,7139,42,9
12/13/2021,Hawaii,1431603,3,7142,41,8
12/14/2021,Hawaii,1431603,5,7147,38,8
12/15/2021,Hawaii,1431603,6,7153,40,8
12/16/2021,Hawaii,1431603,9,7162,47,7
12/17/2021,Hawaii,1431603,7,7169,52,9
12/18/2021,Hawaii,1431603,9,7178,51,11
12/19/2021,Hawaii,1431603,10,7188,56,9
12/20/2021,Hawaii,1431603,10,7198,62,11
12/21/2021,Hawaii,1431603,16,7214,65,14
12/22/2021,Hawaii,1431603,15,7229,65,13
12/23/2021,Hawaii,1431603,16,7245,69,15
12/24/2021,Hawaii,1431603,13,7258,78,14
12/25/2021,Hawaii,1431603,11,7269,69,12
12/26/2021,Hawaii,1431603,22,7291,86,14
12/27/2021,Hawaii,1431603,26,7317,100,19
12/28/2021,Hawaii,1431603,31,7348,121,23
12/29/2021,Hawaii,1431603,24,7372,131,22
12/30/2021,Hawaii,1431603,32,7404,147,28
12/31/2021,Hawaii,1431603,37,7441,161,26
1/1/2022,Hawaii,1431603,39,7480,179,29
1/2/2022,Hawaii,1431603,30,7510,185,28
1/3/2022,Hawaii,1431603,47,7557,196,37
1/4/2022,Hawaii,1431603,47,7604,197,29
1/5/2022,Hawaii,1431603,41,7645,207,35
1/6/2022,Hawaii,1431603,57,7702,230,35
1/7/2022,Hawaii,1431603,54,7756,238,38
1/8/2022,Hawaii,1431603,47,7803,257,38
1/9/2022,Hawaii,1431603,66,7869,298,40
1/10/2022,Hawaii,1431603,47,7916,285,33
1/11/2022,Hawaii,1431603,50,7966,314,41
1/12/2022,Hawaii,1431603,64,8030,330,35
1/13/2022,Hawaii,1431603,57,8087,347,35
1/14/2022,Hawaii,1431603,53,8140,357,43
1/15/2022,Hawaii,1431603,52,8192,334,41
1/16/2022,Hawaii,1431603,50,8242,347,43
1/17/2022,Hawaii,1431603,52,8294,365,43
1/18/2022,Hawaii,1431603,61,8355,381,46
1/19/2022,Hawaii,1431603,66,8421,373,48
1/20/2022,Hawaii,1431603,53,8474,378,44
1/21/2022,Hawaii,1431603,66,8540,382,48
1/22/2022,Hawaii,1431603,62,8602,396,44
1/23/2022,Hawaii,1431603,55,8657,406,50
1/24/2022,Hawaii,1431603,51,8708,399,54
1/25/2022,Hawaii,1431603,41,8749,399,56
1/26/2022,Hawaii,1431603,46,8795,392,59
1/27/2022,Hawaii,1431603,42,8837,397,60
1/28/2022,Hawaii,1431603,52,8889,379,60
1/29/2022,Hawaii,1431603,53,8942,363,61
1/30/2022,Hawaii,1431603,40,8982,361,57
1/31/2022,Hawaii,1431603,42,9024,340,61
2/1/2022,Hawaii,1431603,49,9073,347,54
2/2/2022,Hawaii,1431603,29,9102,323,49
2/3/2022,Hawaii,1431603,31,9133,294,39
2/4/2022,Hawaii,1431603,29,9162,292,36
2/5/2022,Hawaii,1431603,32,9194,262,34
2/6/2022,Hawaii,1431603,15,9209,262,32
2/7/2022,Hawaii,1431603,29,9238,243,27
2/8/2022,Hawaii,1431603,29,9267,233,25
2/9/2022,Hawaii,1431603,29,9296,233,25
7/1/2021,Iowa,3046355,8,21285,72,18
7/2/2021,Iowa,3046355,13,21298,74,19
7/3/2021,Iowa,3046355,10,21308,72,17
7/4/2021,Iowa,3046355,13,21321,78,22
7/5/2021,Iowa,3046355,8,21329,76,24
7/6/2021,Iowa,3046355,12,21341,85,25
7/7/2021,Iowa,3046355,16,21357,80,26
7/8/2021,Iowa,3046355,12,21369,73,21
7/9/2021,Iowa,3046355,15,21384,78,22
7/10/2021,Iowa,3046355,19,21403,79,21
7/11/2021,Iowa,3046355,8,21411,71,20
7/12/2021,Iowa,3046355,9,21420,74,18
7/13/2021,Iowa,3046355,15,21435,77,22
7/14/2021,Iowa,3046355,17,21452,71,24
7/15/2021,Iowa,3046355,14,21466,76,21
7/16/2021,Iowa,3046355,23,21489,84,23
7/17/2021,Iowa,3046355,14,21503,88,23
7/18/2021,Iowa,3046355,14,21517,88,23
7/19/2021,Iowa,3046355,18,21535,95,27
7/20/2021,Iowa,3046355,26,21561,101,33
7/21/2021,Iowa,3046355,23,21584,106,39
7/22/2021,Iowa,3046355,25,21609,120,42
7/23/2021,Iowa,3046355,24,21633,125,47
7/24/2021,Iowa,3046355,26,21659,128,51
7/25/2021,Iowa,3046355,20,21679,141,56
7/26/2021,Iowa,3046355,17,21696,138,54
7/27/2021,Iowa,3046355,33,21729,157,54
7/28/2021,Iowa,3046355,30,21759,158,48
7/29/2021,Iowa,3046355,27,21786,157,50
7/30/2021,Iowa,3046355,33,21819,164,47
7/31/2021,Iowa,3046355,31,21850,164,46
8/1/2021,Iowa,3046355,40,21890,174,52
8/2/2021,Iowa,3046355,33,21923,183,49
8/3/2021,Iowa,3046355,44,21967,201,56
8/4/2021,Iowa,3046355,46,22013,214,62
8/5/2021,Iowa,3046355,60,22073,237,59
8/6/2021,Iowa,3046355,46,22119,248,66
8/7/2021,Iowa,3046355,51,22170,264,76
8/8/2021,Iowa,3046355,45,22215,278,80
8/9/2021,Iowa,3046355,43,22258,301,83
8/10/2021,Iowa,3046355,66,22324,335,92
8/11/2021,Iowa,3046355,62,22386,354,101
8/12/2021,Iowa,3046355,53,22439,357,100
8/13/2021,Iowa,3046355,58,22497,356,98
8/14/2021,Iowa,3046355,66,22563,379,90
8/15/2021,Iowa,3046355,60,22623,393,99
8/16/2021,Iowa,3046355,62,22685,410,99
8/17/2021,Iowa,3046355,63,22748,401,104
8/18/2021,Iowa,3046355,61,22809,396,98
8/19/2021,Iowa,3046355,79,22888,410,100
8/20/2021,Iowa,3046355,98,22986,418,97
8/21/2021,Iowa,3046355,65,23051,417,112
8/22/2021,Iowa,3046355,68,23119,440,113
8/23/2021,Iowa,3046355,78,23197,472,119
8/24/2021,Iowa,3046355,78,23275,485,129
8/25/2021,Iowa,3046355,88,23363,498,130
8/26/2021,Iowa,3046355,95,23458,524,133
8/27/2021,Iowa,3046355,75,23533,532,143
8/28/2021,Iowa,3046355,90,23623,536,144
8/29/2021,Iowa,3046355,81,23704,556,137
8/30/2021,Iowa,3046355,79,23783,564,140
8/31/2021,Iowa,3046355,79,23862,547,145
9/1/2021,Iowa,3046355,77,23939,522,139
9/2/2021,Iowa,3046355,97,24036,527,140
9/3/2021,Iowa,3046355,74,24110,534,141
9/4/2021,Iowa,3046355,81,24191,539,135
9/5/2021,Iowa,3046355,63,24254,542,146
9/6/2021,Iowa,3046355,81,24335,553,154
9/7/2021,Iowa,3046355,85,24420,578,153
9/8/2021,Iowa,3046355,83,24503,562,160
9/9/2021,Iowa,3046355,77,24580,553,146
9/10/2021,Iowa,3046355,76,24656,531,146
9/11/2021,Iowa,3046355,72,24728,528,144
9/12/2021,Iowa,3046355,60,24788,548,148
9/13/2021,Iowa,3046355,69,24857,564,153
9/14/2021,Iowa,3046355,93,24950,576,165
9/15/2021,Iowa,3046355,83,25033,571,148
9/16/2021,Iowa,3046355,94,25127,581,143
9/17/2021,Iowa,3046355,74,25201,574,144
9/18/2021,Iowa,3046355,85,25286,551,146
9/19/2021,Iowa,3046355,73,25359,579,154
9/20/2021,Iowa,3046355,122,25481,635,155
9/21/2021,Iowa,3046355,97,25578,642,156
9/22/2021,Iowa,3046355,87,25665,635,162
9/23/2021,Iowa,3046355,107,25772,642,160
9/24/2021,Iowa,3046355,111,25883,659,168
9/25/2021,Iowa,3046355,98,25981,646,163
9/26/2021,Iowa,3046355,79,26060,640,148
9/27/2021,Iowa,3046355,83,26143,646,148
9/28/2021,Iowa,3046355,91,26234,624,155
9/29/2021,Iowa,3046355,91,26325,613,156
9/30/2021,Iowa,3046355,102,26427,634,147
10/1/2021,Iowa,3046355,106,26533,621,145
10/2/2021,Iowa,3046355,101,26634,632,130
10/3/2021,Iowa,3046355,79,26713,630,137
10/4/2021,Iowa,3046355,87,26800,631,141
10/5/2021,Iowa,3046355,89,26889,627,141
10/6/2021,Iowa,3046355,91,26980,600,148
10/7/2021,Iowa,3046355,87,27067,573,145
10/8/2021,Iowa,3046355,90,27157,592,140
10/9/2021,Iowa,3046355,88,27245,581,146
10/10/2021,Iowa,3046355,58,27303,565,149
10/11/2021,Iowa,3046355,77,27380,599,151
10/12/2021,Iowa,3046355,89,27469,598,147
10/13/2021,Iowa,3046355,82,27551,588,148
10/14/2021,Iowa,3046355,72,27623,575,136
10/15/2021,Iowa,3046355,91,27714,588,141
10/16/2021,Iowa,3046355,83,27797,587,138
10/17/2021,Iowa,3046355,53,27850,561,145
10/18/2021,Iowa,3046355,64,27914,566,141
10/19/2021,Iowa,3046355,59,27973,557,142
10/20/2021,Iowa,3046355,63,28036,534,143
10/21/2021,Iowa,3046355,80,28116,526,138
10/22/2021,Iowa,3046355,78,28194,543,136
10/23/2021,Iowa,3046355,74,28268,533,136
10/24/2021,Iowa,3046355,54,28322,521,127
10/25/2021,Iowa,3046355,69,28391,528,133
10/26/2021,Iowa,3046355,73,28464,531,128
10/27/2021,Iowa,3046355,66,28530,513,114
10/28/2021,Iowa,3046355,66,28596,493,117
10/29/2021,Iowa,3046355,79,28675,484,111
10/30/2021,Iowa,3046355,66,28741,474,112
10/31/2021,Iowa,3046355,58,28799,468,113
11/1/2021,Iowa,3046355,45,28844,467,108
11/2/2021,Iowa,3046355,75,28919,484,109
11/3/2021,Iowa,3046355,78,28997,476,120
11/4/2021,Iowa,3046355,68,29065,465,114
11/5/2021,Iowa,3046355,79,29144,482,106
11/6/2021,Iowa,3046355,70,29214,464,105
11/7/2021,Iowa,3046355,69,29283,480,110
11/8/2021,Iowa,3046355,82,29365,513,107
11/9/2021,Iowa,3046355,88,29453,519,112
11/10/2021,Iowa,3046355,76,29529,519,116
11/11/2021,Iowa,3046355,51,29580,487,112
11/12/2021,Iowa,3046355,88,29668,523,111
11/13/2021,Iowa,3046355,84,29752,513,114
11/14/2021,Iowa,3046355,69,29821,526,119
11/15/2021,Iowa,3046355,79,29900,555,120
11/16/2021,Iowa,3046355,97,29997,545,124
11/17/2021,Iowa,3046355,84,30081,538,121
11/18/2021,Iowa,3046355,95,30176,569,124
11/19/2021,Iowa,3046355,79,30255,573,122
11/20/2021,Iowa,3046355,99,30354,570,127
11/21/2021,Iowa,3046355,78,30432,580,133
11/22/2021,Iowa,3046355,80,30512,596,138
11/23/2021,Iowa,3046355,109,30621,623,147
11/24/2021,Iowa,3046355,77,30698,616,142
11/25/2021,Iowa,3046355,100,30798,617,143
11/26/2021,Iowa,3046355,67,30865,615,136
11/27/2021,Iowa,3046355,111,30976,637,139
11/28/2021,Iowa,3046355,86,31062,663,152
11/29/2021,Iowa,3046355,91,31153,697,162
11/30/2021,Iowa,3046355,124,31277,721,169
12/1/2021,Iowa,3046355,103,31380,730,162
12/2/2021,Iowa,3046355,112,31492,747,158
12/3/2021,Iowa,3046355,114,31606,755,154
12/4/2021,Iowa,3046355,114,31720,736,157
12/5/2021,Iowa,3046355,83,31803,719,162
12/6/2021,Iowa,3046355,113,31916,753,174
12/7/2021,Iowa,3046355,131,32047,781,184
12/8/2021,Iowa,3046355,97,32144,785,182
12/9/2021,Iowa,3046355,134,32278,812,181
12/10/2021,Iowa,3046355,118,32396,812,179
12/11/2021,Iowa,3046355,112,32508,806,169
12/12/2021,Iowa,3046355,109,32617,817,168
12/13/2021,Iowa,3046355,98,32715,842,167
12/14/2021,Iowa,3046355,109,32824,824,173
12/15/2021,Iowa,3046355,120,32944,835,175
12/16/2021,Iowa,3046355,118,33062,815,169
12/17/2021,Iowa,3046355,131,33193,794,172
12/18/2021,Iowa,3046355,114,33307,818,178
12/19/2021,Iowa,3046355,88,33395,789,170
12/20/2021,Iowa,3046355,82,33477,767,165
12/21/2021,Iowa,3046355,131,33608,745,159
12/22/2021,Iowa,3046355,116,33724,743,151
12/23/2021,Iowa,3046355,108,33832,728,158
12/24/2021,Iowa,3046355,113,33945,733,167
12/25/2021,Iowa,3046355,110,34055,703,179
12/26/2021,Iowa,3046355,100,34155,710,167
12/27/2021,Iowa,3046355,107,34262,707,160
12/28/2021,Iowa,3046355,126,34388,711,163
12/29/2021,Iowa,3046355,120,34508,733,165
12/30/2021,Iowa,3046355,118,34626,772,172
12/31/2021,Iowa,3046355,135,34761,770,162
1/1/2022,Iowa,3046355,106,34867,770,156
1/2/2022,Iowa,3046355,87,34954,769,165
1/3/2022,Iowa,3046355,119,35073,776,153
1/4/2022,Iowa,3046355,150,35223,792,161
1/5/2022,Iowa,3046355,187,35410,870,176
1/6/2022,Iowa,3046355,167,35577,898,179
1/7/2022,Iowa,3046355,170,35747,883,165
1/8/2022,Iowa,3046355,142,35889,870,174
1/9/2022,Iowa,3046355,124,36013,885,187
1/10/2022,Iowa,3046355,147,36160,923,172
1/11/2022,Iowa,3046355,176,36336,922,174
1/12/2022,Iowa,3046355,206,36542,968,173
1/13/2022,Iowa,3046355,208,36750,996,171
1/14/2022,Iowa,3046355,166,36916,961,167
1/15/2022,Iowa,3046355,158,37074,973,172
1/16/2022,Iowa,3046355,107,37181,952,171
1/17/2022,Iowa,3046355,130,37311,1003,177
1/18/2022,Iowa,3046355,163,37474,988,185
1/19/2022,Iowa,3046355,159,37633,991,179
1/20/2022,Iowa,3046355,134,37767,956,178
1/21/2022,Iowa,3046355,165,37932,964,168
1/22/2022,Iowa,3046355,161,38093,933,161
1/23/2022,Iowa,3046355,118,38211,929,168
1/24/2022,Iowa,3046355,126,38337,957,170
1/25/2022,Iowa,3046355,171,38508,926,163
1/26/2022,Iowa,3046355,137,38645,929,138
1/27/2022,Iowa,3046355,160,38805,927,140
1/28/2022,Iowa,3046355,133,38938,898,138
1/29/2022,Iowa,3046355,120,39058,838,133
1/30/2022,Iowa,3046355,111,39169,850,127
1/31/2022,Iowa,3046355,107,39276,837,120
2/1/2022,Iowa,3046355,133,39409,795,109
2/2/2022,Iowa,3046355,117,39526,761,104
2/3/2022,Iowa,3046355,123,39649,735,102
2/4/2022,Iowa,3046355,99,39748,687,101
2/5/2022,Iowa,3046355,120,39868,666,102
2/6/2022,Iowa,3046355,65,39933,640,99
2/7/2022,Iowa,3046355,76,40009,648,103
2/8/2022,Iowa,3046355,95,40104,616,98
2/9/2022,Iowa,3046355,95,40199,616,98
7/1/2021,Idaho,1654930,12,9027,81,22
7/2/2021,Idaho,1654930,3,9030,70,17
7/3/2021,Idaho,1654930,6,9036,73,18
7/4/2021,Idaho,1654930,8,9044,73,20
7/5/2021,Idaho,1654930,5,9049,68,21
7/6/2021,Idaho,1654930,7,9056,65,19
7/7/2021,Idaho,1654930,3,9059,70,21
7/8/2021,Idaho,1654930,12,9071,80,25
7/9/2021,Idaho,1654930,14,9085,88,27
7/10/2021,Idaho,1654930,13,9098,101,35
7/11/2021,Idaho,1654930,12,9110,98,38
7/12/2021,Idaho,1654930,10,9120,99,38
7/13/2021,Idaho,1654930,14,9134,105,36
7/14/2021,Idaho,1654930,17,9151,118,40
7/15/2021,Idaho,1654930,17,9168,120,36
7/16/2021,Idaho,1654930,8,9176,128,41
7/17/2021,Idaho,1654930,12,9188,110,42
7/18/2021,Idaho,1654930,13,9201,116,46
7/19/2021,Idaho,1654930,14,9215,118,45
7/20/2021,Idaho,1654930,15,9230,120,48
7/21/2021,Idaho,1654930,17,9247,104,40
7/22/2021,Idaho,1654930,20,9267,116,42
7/23/2021,Idaho,1654930,19,9286,125,43
7/24/2021,Idaho,1654930,11,9297,125,40
7/25/2021,Idaho,1654930,22,9319,137,45
7/26/2021,Idaho,1654930,17,9336,141,50
7/27/2021,Idaho,1654930,34,9370,157,52
7/28/2021,Idaho,1654930,19,9389,165,49
7/29/2021,Idaho,1654930,26,9415,160,56
7/30/2021,Idaho,1654930,23,9438,164,55
7/31/2021,Idaho,1654930,26,9464,171,60
8/1/2021,Idaho,1654930,24,9488,175,63
8/2/2021,Idaho,1654930,26,9514,178,65
8/3/2021,Idaho,1654930,16,9530,185,70
8/4/2021,Idaho,1654930,35,9565,207,75
8/5/2021,Idaho,1654930,30,9595,211,77
8/6/2021,Idaho,1654930,34,9629,224,78
8/7/2021,Idaho,1654930,35,9664,250,81
8/8/2021,Idaho,1654930,40,9704,262,90
8/9/2021,Idaho,1654930,29,9733,273,95
8/10/2021,Idaho,1654930,46,9779,297,102
8/11/2021,Idaho,1654930,49,9828,330,114
8/12/2021,Idaho,1654930,45,9873,333,117
8/13/2021,Idaho,1654930,44,9917,341,115
8/14/2021,Idaho,1654930,39,9956,337,123
8/15/2021,Idaho,1654930,48,10004,356,127
8/16/2021,Idaho,1654930,58,10062,381,122
8/17/2021,Idaho,1654930,61,10123,409,131
8/18/2021,Idaho,1654930,54,10177,419,140
8/19/2021,Idaho,1654930,34,10211,412,130
8/20/2021,Idaho,1654930,49,10260,409,129
8/21/2021,Idaho,1654930,41,10301,414,131
8/22/2021,Idaho,1654930,43,10344,418,135
8/23/2021,Idaho,1654930,55,10399,432,135
8/24/2021,Idaho,1654930,67,10466,462,139
8/25/2021,Idaho,1654930,53,10519,466,143
8/26/2021,Idaho,1654930,53,10572,462,143
8/27/2021,Idaho,1654930,81,10653,476,144
8/28/2021,Idaho,1654930,74,10727,506,155
8/29/2021,Idaho,1654930,59,10786,507,162
8/30/2021,Idaho,1654930,63,10849,517,162
8/31/2021,Idaho,1654930,78,10927,543,173
9/1/2021,Idaho,1654930,67,10994,528,165
9/2/2021,Idaho,1654930,60,11054,520,163
9/3/2021,Idaho,1654930,69,11123,531,166
9/4/2021,Idaho,1654930,79,11202,562,171
9/5/2021,Idaho,1654930,68,11270,569,171
9/6/2021,Idaho,1654930,60,11330,568,167
9/7/2021,Idaho,1654930,71,11401,577,172
9/8/2021,Idaho,1654930,82,11483,603,163
9/9/2021,Idaho,1654930,87,11570,611,172
9/10/2021,Idaho,1654930,100,11670,657,174
9/11/2021,Idaho,1654930,80,11750,654,173
9/12/2021,Idaho,1654930,80,11830,670,172
9/13/2021,Idaho,1654930,79,11909,688,173
9/14/2021,Idaho,1654930,82,11991,683,176
9/15/2021,Idaho,1654930,78,12069,712,184
9/16/2021,Idaho,1654930,100,12169,741,192
9/17/2021,Idaho,1654930,96,12265,746,206
9/18/2021,Idaho,1654930,102,12367,738,196
9/19/2021,Idaho,1654930,78,12445,734,195
9/20/2021,Idaho,1654930,97,12542,773,202
9/21/2021,Idaho,1654930,102,12644,774,206
9/22/2021,Idaho,1654930,97,12741,792,206
9/23/2021,Idaho,1654930,94,12835,787,207
9/24/2021,Idaho,1654930,107,12942,803,213
9/25/2021,Idaho,1654930,52,12994,784,203
9/26/2021,Idaho,1654930,74,13068,759,192
9/27/2021,Idaho,1654930,77,13145,776,200
9/28/2021,Idaho,1654930,98,13243,787,192
9/29/2021,Idaho,1654930,74,13317,757,188
9/30/2021,Idaho,1654930,81,13398,758,197
10/1/2021,Idaho,1654930,84,13482,753,192
10/2/2021,Idaho,1654930,72,13554,759,194
10/3/2021,Idaho,1654930,66,13620,734,190
10/4/2021,Idaho,1654930,59,13679,725,186
10/5/2021,Idaho,1654930,98,13777,745,187
10/6/2021,Idaho,1654930,73,13850,723,176
10/7/2021,Idaho,1654930,69,13919,714,185
10/8/2021,Idaho,1654930,69,13988,659,176
10/9/2021,Idaho,1654930,79,14067,641,176
10/10/2021,Idaho,1654930,60,14127,647,175
10/11/2021,Idaho,1654930,78,14205,661,179
10/12/2021,Idaho,1654930,64,14269,639,179
10/13/2021,Idaho,1654930,54,14323,613,179
10/14/2021,Idaho,1654930,63,14386,593,180
10/15/2021,Idaho,1654930,57,14443,579,175
10/16/2021,Idaho,1654930,70,14513,566,167
10/17/2021,Idaho,1654930,48,14561,561,171
10/18/2021,Idaho,1654930,60,14621,586,175
10/19/2021,Idaho,1654930,59,14680,593,167
10/20/2021,Idaho,1654930,68,14748,580,163
10/21/2021,Idaho,1654930,62,14810,580,162
10/22/2021,Idaho,1654930,42,14852,555,154
10/23/2021,Idaho,1654930,54,14906,546,161
10/24/2021,Idaho,1654930,59,14965,552,162
10/25/2021,Idaho,1654930,41,15006,540,152
10/26/2021,Idaho,1654930,53,15059,540,146
10/27/2021,Idaho,1654930,46,15105,528,147
10/28/2021,Idaho,1654930,38,15143,516,155
10/29/2021,Idaho,1654930,53,15196,502,157
10/30/2021,Idaho,1654930,50,15246,478,154
10/31/2021,Idaho,1654930,35,15281,465,150
11/1/2021,Idaho,1654930,34,15315,454,146
11/2/2021,Idaho,1654930,44,15359,466,143
11/3/2021,Idaho,1654930,47,15406,448,139
11/4/2021,Idaho,1654930,53,15459,437,137
11/5/2021,Idaho,1654930,51,15510,441,135
11/6/2021,Idaho,1654930,48,15558,429,128
11/7/2021,Idaho,1654930,45,15603,424,131
11/8/2021,Idaho,1654930,33,15636,409,127
11/9/2021,Idaho,1654930,45,15681,388,118
11/10/2021,Idaho,1654930,29,15710,371,118
11/11/2021,Idaho,1654930,29,15739,351,115
11/12/2021,Idaho,1654930,30,15769,335,115
11/13/2021,Idaho,1654930,23,15792,299,106
11/14/2021,Idaho,1654930,32,15824,297,104
11/15/2021,Idaho,1654930,42,15866,351,118
11/16/2021,Idaho,1654930,38,15904,347,108
11/17/2021,Idaho,1654930,34,15938,339,109
11/18/2021,Idaho,1654930,35,15973,334,103
11/19/2021,Idaho,1654930,29,16002,316,101
11/20/2021,Idaho,1654930,29,16031,301,97
11/21/2021,Idaho,1654930,30,16061,301,93
11/22/2021,Idaho,1654930,36,16097,306,101
11/23/2021,Idaho,1654930,35,16132,310,98
11/24/2021,Idaho,1654930,33,16165,313,94
11/25/2021,Idaho,1654930,36,16201,317,91
11/26/2021,Idaho,1654930,29,16230,310,85
11/27/2021,Idaho,1654930,36,16266,307,82
11/28/2021,Idaho,1654930,23,16289,311,83
11/29/2021,Idaho,1654930,17,16306,295,89
11/30/2021,Idaho,1654930,30,16336,284,90
12/1/2021,Idaho,1654930,31,16367,286,92
12/2/2021,Idaho,1654930,24,16391,275,90
12/3/2021,Idaho,1654930,40,16431,283,84
12/4/2021,Idaho,1654930,34,16465,293,79
12/5/2021,Idaho,1654930,33,16498,297,80
12/6/2021,Idaho,1654930,33,16531,308,82
12/7/2021,Idaho,1654930,30,16561,305,84
12/8/2021,Idaho,1654930,42,16603,302,87
12/9/2021,Idaho,1654930,34,16637,311,86
12/10/2021,Idaho,1654930,29,16666,309,82
12/11/2021,Idaho,1654930,24,16690,303,82
12/12/2021,Idaho,1654930,23,16713,297,82
12/13/2021,Idaho,1654930,23,16736,291,86
12/14/2021,Idaho,1654930,22,16758,291,91
12/15/2021,Idaho,1654930,34,16792,281,96
12/16/2021,Idaho,1654930,18,16810,277,95
12/17/2021,Idaho,1654930,24,16834,268,89
12/18/2021,Idaho,1654930,26,16860,252,86
12/19/2021,Idaho,1654930,16,16876,243,86
12/20/2021,Idaho,1654930,31,16907,242,82
12/21/2021,Idaho,1654930,31,16938,231,76
12/22/2021,Idaho,1654930,29,16967,230,79
12/23/2021,Idaho,1654930,24,16991,230,75
12/24/2021,Idaho,1654930,22,17013,218,73
12/25/2021,Idaho,1654930,23,17036,211,75
12/26/2021,Idaho,1654930,24,17060,218,77
12/27/2021,Idaho,1654930,25,17085,234,76
12/28/2021,Idaho,1654930,23,17108,242,74
12/29/2021,Idaho,1654930,23,17131,240,74
12/30/2021,Idaho,1654930,23,17154,237,75
12/31/2021,Idaho,1654930,27,17181,238,76
1/1/2022,Idaho,1654930,31,17212,251,80
1/2/2022,Idaho,1654930,38,17250,270,75
1/3/2022,Idaho,1654930,26,17276,271,82
1/4/2022,Idaho,1654930,44,17320,284,84
1/5/2022,Idaho,1654930,37,17357,272,80
1/6/2022,Idaho,1654930,46,17403,276,83
1/7/2022,Idaho,1654930,67,17470,314,87
1/8/2022,Idaho,1654930,49,17519,337,91
1/9/2022,Idaho,1654930,51,17570,343,90
1/10/2022,Idaho,1654930,45,17615,356,95
1/11/2022,Idaho,1654930,49,17664,361,96
1/12/2022,Idaho,1654930,61,17725,386,101
1/13/2022,Idaho,1654930,55,17780,385,91
1/14/2022,Idaho,1654930,55,17835,375,87
1/15/2022,Idaho,1654930,53,17888,370,84
1/16/2022,Idaho,1654930,58,17946,397,80
1/17/2022,Idaho,1654930,66,18012,420,82
1/18/2022,Idaho,1654930,79,18091,465,106
1/19/2022,Idaho,1654930,90,18181,490,91
1/20/2022,Idaho,1654930,73,18254,493,101
1/21/2022,Idaho,1654930,72,18326,512,101
1/22/2022,Idaho,1654930,61,18387,510,98
1/23/2022,Idaho,1654930,74,18461,522,109
1/24/2022,Idaho,1654930,62,18523,541,110
1/25/2022,Idaho,1654930,101,18624,570,111
1/26/2022,Idaho,1654930,87,18711,592,107
1/27/2022,Idaho,1654930,90,18801,606,108
1/28/2022,Idaho,1654930,81,18882,590,107
1/29/2022,Idaho,1654930,94,18976,605,110
1/30/2022,Idaho,1654930,72,19048,617,104
1/31/2022,Idaho,1654930,75,19123,609,110
2/1/2022,Idaho,1654930,73,19196,599,98
2/2/2022,Idaho,1654930,78,19274,596,102
2/3/2022,Idaho,1654930,77,19351,575,102
2/4/2022,Idaho,1654930,83,19434,559,104
2/5/2022,Idaho,1654930,74,19508,542,110
2/6/2022,Idaho,1654930,40,19548,518,105
2/7/2022,Idaho,1654930,60,19608,534,119
2/8/2022,Idaho,1654930,84,19692,534,121
2/9/2022,Idaho,1654930,84,19776,534,121
7/1/2021,Illinois,12859995,51,83873,323,74
7/2/2021,Illinois,12859995,55,83928,305,71
7/3/2021,Illinois,12859995,38,83966,289,64
7/4/2021,Illinois,12859995,32,83998,280,64
7/5/2021,Illinois,12859995,44,84042,293,64
7/6/2021,Illinois,12859995,51,84093,306,65
7/7/2021,Illinois,12859995,49,84142,293,56
7/8/2021,Illinois,12859995,55,84197,300,55
7/9/2021,Illinois,12859995,64,84261,314,66
7/10/2021,Illinois,12859995,58,84319,306,60
7/11/2021,Illinois,12859995,72,84391,333,65
7/12/2021,Illinois,12859995,58,84449,348,63
7/13/2021,Illinois,12859995,69,84518,354,67
7/14/2021,Illinois,12859995,71,84589,368,76
7/15/2021,Illinois,12859995,65,84654,369,78
7/16/2021,Illinois,12859995,70,84724,389,82
7/17/2021,Illinois,12859995,69,84793,401,80
7/18/2021,Illinois,12859995,70,84863,428,80
7/19/2021,Illinois,12859995,79,84942,457,90
7/20/2021,Illinois,12859995,98,85040,490,101
7/21/2021,Illinois,12859995,95,85135,513,99
7/22/2021,Illinois,12859995,84,85219,515,109
7/23/2021,Illinois,12859995,104,85323,550,123
7/24/2021,Illinois,12859995,112,85435,570,120
7/25/2021,Illinois,12859995,96,85531,580,120
7/26/2021,Illinois,12859995,111,85642,646,134
7/27/2021,Illinois,12859995,122,85764,697,156
7/28/2021,Illinois,12859995,140,85904,745,155
7/29/2021,Illinois,12859995,148,86052,762,153
7/30/2021,Illinois,12859995,159,86211,778,156
7/31/2021,Illinois,12859995,166,86377,818,177
8/1/2021,Illinois,12859995,128,86505,846,178
8/2/2021,Illinois,12859995,157,86662,913,205
8/3/2021,Illinois,12859995,200,86862,997,223
8/4/2021,Illinois,12859995,192,87054,1031,221
8/5/2021,Illinois,12859995,172,87226,1042,231
8/6/2021,Illinois,12859995,213,87439,1121,228
8/7/2021,Illinois,12859995,197,87636,1144,226
8/8/2021,Illinois,12859995,201,87837,1237,260
8/9/2021,Illinois,12859995,213,88050,1286,269
8/10/2021,Illinois,12859995,233,88283,1369,288
8/11/2021,Illinois,12859995,239,88522,1442,293
8/12/2021,Illinois,12859995,235,88757,1492,323
8/13/2021,Illinois,12859995,253,89010,1525,340
8/14/2021,Illinois,12859995,287,89297,1587,359
8/15/2021,Illinois,12859995,246,89543,1655,379
8/16/2021,Illinois,12859995,220,89763,1730,390
8/17/2021,Illinois,12859995,293,90056,1775,399
8/18/2021,Illinois,12859995,274,90330,1775,390
8/19/2021,Illinois,12859995,276,90606,1770,397
8/20/2021,Illinois,12859995,262,90868,1811,397
8/21/2021,Illinois,12859995,267,91135,1819,427
8/22/2021,Illinois,12859995,249,91384,1842,432
8/23/2021,Illinois,12859995,261,91645,1881,421
8/24/2021,Illinois,12859995,314,91959,1973,444
8/25/2021,Illinois,12859995,274,92233,1958,446
8/26/2021,Illinois,12859995,293,92526,2000,441
8/27/2021,Illinois,12859995,312,92838,2026,462
8/28/2021,Illinois,12859995,298,93136,2013,476
8/29/2021,Illinois,12859995,243,93379,1974,474
8/30/2021,Illinois,12859995,261,93640,2027,482
8/31/2021,Illinois,12859995,263,93903,2018,491
9/1/2021,Illinois,12859995,316,94219,2043,483
9/2/2021,Illinois,12859995,283,94502,2065,528
9/3/2021,Illinois,12859995,289,94791,2037,525
9/4/2021,Illinois,12859995,275,95066,2054,520
9/5/2021,Illinois,12859995,281,95347,2089,516
9/6/2021,Illinois,12859995,244,95591,2110,525
9/7/2021,Illinois,12859995,266,95857,2140,535
9/8/2021,Illinois,12859995,330,96187,2148,556
9/9/2021,Illinois,12859995,281,96468,2130,540
9/10/2021,Illinois,12859995,273,96741,2101,524
9/11/2021,Illinois,12859995,234,96975,2047,515
9/12/2021,Illinois,12859995,222,97197,2044,524
9/13/2021,Illinois,12859995,221,97418,2039,511
9/14/2021,Illinois,12859995,243,97661,1969,485
9/15/2021,Illinois,12859995,259,97920,1926,462
9/16/2021,Illinois,12859995,237,98157,1909,470
9/17/2021,Illinois,12859995,251,98408,1891,467
9/18/2021,Illinois,12859995,240,98648,1822,459
9/19/2021,Illinois,12859995,202,98850,1816,455
9/20/2021,Illinois,12859995,249,99099,1862,440
9/21/2021,Illinois,12859995,244,99343,1826,450
9/22/2021,Illinois,12859995,238,99581,1794,447
9/23/2021,Illinois,12859995,237,99818,1739,428
9/24/2021,Illinois,12859995,245,100063,1721,410
9/25/2021,Illinois,12859995,204,100267,1670,408
9/26/2021,Illinois,12859995,178,100445,1683,418
9/27/2021,Illinois,12859995,203,100648,1677,407
9/28/2021,Illinois,12859995,236,100884,1657,405
9/29/2021,Illinois,12859995,188,101072,1596,393
9/30/2021,Illinois,12859995,211,101283,1596,391
10/1/2021,Illinois,12859995,213,101496,1516,375
10/2/2021,Illinois,12859995,167,101663,1473,375
10/3/2021,Illinois,12859995,152,101815,1477,370
10/4/2021,Illinois,12859995,146,101961,1487,364
10/5/2021,Illinois,12859995,191,102152,1490,373
10/6/2021,Illinois,12859995,188,102340,1478,374
10/7/2021,Illinois,12859995,201,102541,1504,367
10/8/2021,Illinois,12859995,188,102729,1488,366
10/9/2021,Illinois,12859995,185,102914,1402,1202
10/10/2021,Illinois,12859995,175,103089,1399,1813
10/11/2021,Illinois,12859995,160,103249,1427,1984
10/12/2021,Illinois,12859995,181,103430,1435,2063
10/13/2021,Illinois,12859995,161,103591,1378,2032
10/14/2021,Illinois,12859995,164,103755,1325,2005
10/15/2021,Illinois,12859995,165,103920,1300,1978
10/16/2021,Illinois,12859995,161,104081,1257,1779
10/17/2021,Illinois,12859995,138,104219,1248,1697
10/18/2021,Illinois,12859995,145,104364,1246,1891
10/19/2021,Illinois,12859995,155,104519,1178,1975
10/20/2021,Illinois,12859995,151,104670,1145,1994
10/21/2021,Illinois,12859995,147,104817,1103,1951
10/22/2021,Illinois,12859995,131,104948,1076,1967
10/23/2021,Illinois,12859995,141,105089,1093,1778
10/24/2021,Illinois,12859995,110,105199,1055,1705
10/25/2021,Illinois,12859995,103,105302,1049,1865
10/26/2021,Illinois,12859995,125,105427,1063,1918
10/27/2021,Illinois,12859995,151,105578,1051,1941
10/28/2021,Illinois,12859995,154,105732,1032,1940
10/29/2021,Illinois,12859995,154,105886,1026,268
10/30/2021,Illinois,12859995,137,106023,1043,266
10/31/2021,Illinois,12859995,133,106156,1055,267
11/1/2021,Illinois,12859995,118,106274,1097,262
11/2/2021,Illinois,12859995,143,106417,1098,262
11/3/2021,Illinois,12859995,160,106577,1077,252
11/4/2021,Illinois,12859995,141,106718,1101,256
11/5/2021,Illinois,12859995,134,106852,1110,266
11/6/2021,Illinois,12859995,142,106994,1121,262
11/7/2021,Illinois,12859995,147,107141,1147,260
11/8/2021,Illinois,12859995,156,107297,1202,271
11/9/2021,Illinois,12859995,194,107491,1234,293
11/10/2021,Illinois,12859995,186,107677,1287,291
11/11/2021,Illinois,12859995,189,107866,1328,300
11/12/2021,Illinois,12859995,187,108053,1352,307
11/13/2021,Illinois,12859995,188,108241,1317,282
11/14/2021,Illinois,12859995,182,108423,1376,296
11/15/2021,Illinois,12859995,189,108612,1408,301
11/16/2021,Illinois,12859995,222,108834,1453,311
11/17/2021,Illinois,12859995,227,109061,1482,300
11/18/2021,Illinois,12859995,226,109287,1553,320
11/19/2021,Illinois,12859995,191,109478,1553,326
11/20/2021,Illinois,12859995,206,109684,1523,326
11/21/2021,Illinois,12859995,223,109907,1602,326
11/22/2021,Illinois,12859995,237,110144,1687,352
11/23/2021,Illinois,12859995,278,110422,1784,359
11/24/2021,Illinois,12859995,290,110712,1828,388
11/25/2021,Illinois,12859995,270,110982,1835,384
11/26/2021,Illinois,12859995,231,111213,1876,374
11/27/2021,Illinois,12859995,329,111542,1951,397
11/28/2021,Illinois,12859995,271,111813,2036,424
11/29/2021,Illinois,12859995,273,112086,2123,440
11/30/2021,Illinois,12859995,342,112428,2200,455
12/1/2021,Illinois,12859995,359,112787,2348,489
12/2/2021,Illinois,12859995,374,113161,2356,516
12/3/2021,Illinois,12859995,362,113523,2428,530
12/4/2021,Illinois,12859995,395,113918,2499,536
12/5/2021,Illinois,12859995,375,114293,2615,552
12/6/2021,Illinois,12859995,386,114679,2699,582
12/7/2021,Illinois,12859995,433,115112,2851,623
12/8/2021,Illinois,12859995,408,115520,2918,642
12/9/2021,Illinois,12859995,405,115925,2940,661
12/10/2021,Illinois,12859995,470,116395,3038,658
12/11/2021,Illinois,12859995,495,116890,3112,705
12/12/2021,Illinois,12859995,436,117326,3194,718
12/13/2021,Illinois,12859995,399,117725,3276,729
12/14/2021,Illinois,12859995,450,118175,3326,742
12/15/2021,Illinois,12859995,470,118645,3312,738
12/16/2021,Illinois,12859995,506,119151,3477,757
12/17/2021,Illinois,12859995,487,119638,3536,760
12/18/2021,Illinois,12859995,466,120104,3447,725
12/19/2021,Illinois,12859995,429,120533,3551,770
12/20/2021,Illinois,12859995,452,120985,3608,790
12/21/2021,Illinois,12859995,556,121541,3705,814
12/22/2021,Illinois,12859995,561,122102,3853,813
12/23/2021,Illinois,12859995,591,122693,3900,824
12/24/2021,Illinois,12859995,600,123293,4017,857
12/25/2021,Illinois,12859995,529,123822,4139,856
12/26/2021,Illinois,12859995,599,124421,4376,898
12/27/2021,Illinois,12859995,650,125071,4640,941
12/28/2021,Illinois,12859995,772,125843,4905,968
12/29/2021,Illinois,12859995,805,126648,5164,1005
12/30/2021,Illinois,12859995,853,127501,5409,992
12/31/2021,Illinois,12859995,842,128343,5557,1004
1/1/2022,Illinois,12859995,780,129123,5614,1032
1/2/2022,Illinois,12859995,775,129898,5890,1031
1/3/2022,Illinois,12859995,749,130647,6151,1058
1/4/2022,Illinois,12859995,928,131575,6326,1076
1/5/2022,Illinois,12859995,946,132521,6538,1074
1/6/2022,Illinois,12859995,945,133466,6714,1100
1/7/2022,Illinois,12859995,1009,134475,6807,1110
1/8/2022,Illinois,12859995,946,135421,6786,1102
1/9/2022,Illinois,12859995,843,136264,6802,1107
1/10/2022,Illinois,12859995,821,137085,6933,1077
1/11/2022,Illinois,12859995,893,137978,6964,1088
1/12/2022,Illinois,12859995,1005,138983,7117,1107
1/13/2022,Illinois,12859995,898,139881,7088,1110
1/14/2022,Illinois,12859995,918,140799,6991,1093
1/15/2022,Illinois,12859995,870,141669,6681,1095
1/16/2022,Illinois,12859995,680,142349,6573,1059
1/17/2022,Illinois,12859995,707,143056,6486,1087
1/18/2022,Illinois,12859995,773,143829,6307,1069
1/19/2022,Illinois,12859995,742,144571,6151,1020
1/20/2022,Illinois,12859995,680,145251,5952,979
1/21/2022,Illinois,12859995,673,145924,5692,953
1/22/2022,Illinois,12859995,614,146538,5297,913
1/23/2022,Illinois,12859995,502,147040,5161,907
1/24/2022,Illinois,12859995,478,147518,5020,889
1/25/2022,Illinois,12859995,630,148148,4884,862
1/26/2022,Illinois,12859995,565,148713,4695,837
1/27/2022,Illinois,12859995,476,149189,4453,771
1/28/2022,Illinois,12859995,505,149694,4198,720
1/29/2022,Illinois,12859995,461,150155,3890,667
1/30/2022,Illinois,12859995,360,150515,3774,642
1/31/2022,Illinois,12859995,368,150883,3683,642
2/1/2022,Illinois,12859995,461,151344,3526,625
2/2/2022,Illinois,12859995,397,151741,3257,574
2/3/2022,Illinois,12859995,354,152095,3126,566
2/4/2022,Illinois,12859995,339,152434,2954,544
2/5/2022,Illinois,12859995,333,152767,2735,499
2/6/2022,Illinois,12859995,292,153059,2698,485
2/7/2022,Illinois,12859995,264,153323,2578,465
2/8/2022,Illinois,12859995,310,153633,2458,466
2/9/2022,Illinois,12859995,317,153950,2452,460
7/1/2021,Indiana,6619680,29,53147,219,72
7/2/2021,Indiana,6619680,25,53172,209,70
7/3/2021,Indiana,6619680,29,53201,202,70
7/4/2021,Indiana,6619680,28,53229,209,67
7/5/2021,Indiana,6619680,30,53259,223,71
7/6/2021,Indiana,6619680,42,53301,231,71
7/7/2021,Indiana,6619680,50,53351,230,70
7/8/2021,Indiana,6619680,48,53399,233,71
7/9/2021,Indiana,6619680,34,53433,227,69
7/10/2021,Indiana,6619680,50,53483,237,62
7/11/2021,Indiana,6619680,27,53510,242,67
7/12/2021,Indiana,6619680,42,53552,255,71
7/13/2021,Indiana,6619680,52,53604,268,77
7/14/2021,Indiana,6619680,54,53658,271,83
7/15/2021,Indiana,6619680,61,53719,294,94
7/16/2021,Indiana,6619680,64,53783,311,103
7/17/2021,Indiana,6619680,44,53827,313,108
7/18/2021,Indiana,6619680,40,53867,314,104
7/19/2021,Indiana,6619680,55,53922,326,106
7/20/2021,Indiana,6619680,60,53982,342,118
7/21/2021,Indiana,6619680,65,54047,357,131
7/22/2021,Indiana,6619680,75,54122,390,141
7/23/2021,Indiana,6619680,72,54194,407,150
7/24/2021,Indiana,6619680,86,54280,437,150
7/25/2021,Indiana,6619680,74,54354,452,145
7/26/2021,Indiana,6619680,91,54445,526,175
7/27/2021,Indiana,6619680,101,54546,547,184
7/28/2021,Indiana,6619680,94,54640,594,197
7/29/2021,Indiana,6619680,101,54741,582,193
7/30/2021,Indiana,6619680,106,54847,615,200
7/31/2021,Indiana,6619680,111,54958,626,210
8/1/2021,Indiana,6619680,100,55058,622,215
8/2/2021,Indiana,6619680,117,55175,718,241
8/3/2021,Indiana,6619680,133,55308,722,255
8/4/2021,Indiana,6619680,147,55455,777,283
8/5/2021,Indiana,6619680,144,55599,792,262
8/6/2021,Indiana,6619680,164,55763,864,271
8/7/2021,Indiana,6619680,150,55913,877,275
8/8/2021,Indiana,6619680,142,56055,924,301
8/9/2021,Indiana,6619680,167,56222,1024,312
8/10/2021,Indiana,6619680,202,56424,1027,308
8/11/2021,Indiana,6619680,179,56603,1104,348
8/12/2021,Indiana,6619680,222,56825,1157,357
8/13/2021,Indiana,6619680,210,57035,1236,371
8/14/2021,Indiana,6619680,179,57214,1152,349
8/15/2021,Indiana,6619680,216,57430,1273,382
8/16/2021,Indiana,6619680,203,57633,1291,399
8/17/2021,Indiana,6619680,220,57853,1316,395
8/18/2021,Indiana,6619680,242,58095,1437,428
8/19/2021,Indiana,6619680,296,58391,1524,457
8/20/2021,Indiana,6619680,269,58660,1556,472
8/21/2021,Indiana,6619680,270,58930,1538,473
8/22/2021,Indiana,6619680,271,59201,1600,478
8/23/2021,Indiana,6619680,257,59458,1648,492
8/24/2021,Indiana,6619680,292,59750,1728,504
8/25/2021,Indiana,6619680,294,60044,1813,514
8/26/2021,Indiana,6619680,344,60388,1889,545
8/27/2021,Indiana,6619680,294,60682,1850,534
8/28/2021,Indiana,6619680,305,60987,1892,532
8/29/2021,Indiana,6619680,292,61279,1940,566
8/30/2021,Indiana,6619680,254,61533,1979,577
8/31/2021,Indiana,6619680,339,61872,1951,567
9/1/2021,Indiana,6619680,300,62172,2067,600
9/2/2021,Indiana,6619680,338,62510,2130,603
9/3/2021,Indiana,6619680,314,62824,2144,603
9/4/2021,Indiana,6619680,313,63137,2112,598
9/5/2021,Indiana,6619680,292,63429,2155,630
9/6/2021,Indiana,6619680,265,63694,2141,634
9/7/2021,Indiana,6619680,279,63973,2228,666
9/8/2021,Indiana,6619680,354,64327,2297,702
9/9/2021,Indiana,6619680,342,64669,2281,696
9/10/2021,Indiana,6619680,355,65024,2334,682
9/11/2021,Indiana,6619680,311,65335,2289,690
9/12/2021,Indiana,6619680,274,65609,2307,705
9/13/2021,Indiana,6619680,249,65858,2402,736
9/14/2021,Indiana,6619680,320,66178,2308,724
9/15/2021,Indiana,6619680,310,66488,2322,727
9/16/2021,Indiana,6619680,336,66824,2277,699
9/17/2021,Indiana,6619680,316,67140,2308,682
9/18/2021,Indiana,6619680,284,67424,2250,679
9/19/2021,Indiana,6619680,213,67637,2240,677
9/20/2021,Indiana,6619680,216,67853,2258,686
9/21/2021,Indiana,6619680,294,68147,2211,689
9/22/2021,Indiana,6619680,298,68445,2130,686
9/23/2021,Indiana,6619680,224,68669,2072,654
9/24/2021,Indiana,6619680,242,68911,2029,646
9/25/2021,Indiana,6619680,201,69112,1951,621
9/26/2021,Indiana,6619680,198,69310,1943,622
9/27/2021,Indiana,6619680,183,69493,1897,612
9/28/2021,Indiana,6619680,232,69725,1874,599
9/29/2021,Indiana,6619680,234,69959,1848,590
9/30/2021,Indiana,6619680,216,70175,1742,563
10/1/2021,Indiana,6619680,218,70393,1777,566
10/2/2021,Indiana,6619680,182,70575,1700,568
10/3/2021,Indiana,6619680,169,70744,1693,565
10/4/2021,Indiana,6619680,158,70902,1684,528
10/5/2021,Indiana,6619680,201,71103,1657,516
10/6/2021,Indiana,6619680,191,71294,1652,497
10/7/2021,Indiana,6619680,204,71498,1612,491
10/8/2021,Indiana,6619680,186,71684,1541,505
10/9/2021,Indiana,6619680,194,71878,1509,488
10/10/2021,Indiana,6619680,134,72012,1496,497
10/11/2021,Indiana,6619680,160,72172,1514,491
10/12/2021,Indiana,6619680,191,72363,1499,478
10/13/2021,Indiana,6619680,176,72539,1477,483
10/14/2021,Indiana,6619680,147,72686,1411,463
10/15/2021,Indiana,6619680,177,72863,1378,441
10/16/2021,Indiana,6619680,173,73036,1326,442
10/17/2021,Indiana,6619680,150,73186,1358,431
10/18/2021,Indiana,6619680,138,73324,1361,424
10/19/2021,Indiana,6619680,156,73480,1300,423
10/20/2021,Indiana,6619680,149,73629,1266,410
10/21/2021,Indiana,6619680,164,73793,1262,427
10/22/2021,Indiana,6619680,147,73940,1221,419
10/23/2021,Indiana,6619680,141,74081,1210,429
10/24/2021,Indiana,6619680,127,74208,1175,404
10/25/2021,Indiana,6619680,127,74335,1163,380
10/26/2021,Indiana,6619680,156,74491,1159,386
10/27/2021,Indiana,6619680,125,74616,1130,372
10/28/2021,Indiana,6619680,131,74747,1124,363
10/29/2021,Indiana,6619680,158,74905,1119,356
10/30/2021,Indiana,6619680,140,75045,1106,363
10/31/2021,Indiana,6619680,116,75161,1125,365
11/1/2021,Indiana,6619680,93,75254,1104,365
11/2/2021,Indiana,6619680,147,75401,1110,373
11/3/2021,Indiana,6619680,140,75541,1110,362
11/4/2021,Indiana,6619680,141,75682,1077,334
11/5/2021,Indiana,6619680,138,75820,1057,354
11/6/2021,Indiana,6619680,140,75960,1047,336
11/7/2021,Indiana,6619680,151,76111,1061,316
11/8/2021,Indiana,6619680,117,76228,1091,329
11/9/2021,Indiana,6619680,169,76397,1138,334
11/10/2021,Indiana,6619680,155,76552,1152,344
11/11/2021,Indiana,6619680,167,76719,1146,342
11/12/2021,Indiana,6619680,157,76876,1153,331
11/13/2021,Indiana,6619680,199,77075,1155,343
11/14/2021,Indiana,6619680,162,77237,1255,355
11/15/2021,Indiana,6619680,166,77403,1292,368
11/16/2021,Indiana,6619680,191,77594,1319,370
11/17/2021,Indiana,6619680,193,77787,1328,365
11/18/2021,Indiana,6619680,250,78037,1412,409
11/19/2021,Indiana,6619680,227,78264,1439,398
11/20/2021,Indiana,6619680,215,78479,1478,377
11/21/2021,Indiana,6619680,202,78681,1526,418
11/22/2021,Indiana,6619680,195,78876,1595,443
11/23/2021,Indiana,6619680,285,79161,1644,443
11/24/2021,Indiana,6619680,277,79438,1712,461
11/25/2021,Indiana,6619680,271,79709,1742,476
11/26/2021,Indiana,6619680,230,79939,1808,487
11/27/2021,Indiana,6619680,283,80222,1833,511
11/28/2021,Indiana,6619680,249,80471,1868,525
11/29/2021,Indiana,6619680,282,80753,1984,552
11/30/2021,Indiana,6619680,343,81096,2059,594
12/1/2021,Indiana,6619680,308,81404,2118,609
12/2/2021,Indiana,6619680,335,81739,2171,627
12/3/2021,Indiana,6619680,355,82094,2241,613
12/4/2021,Indiana,6619680,343,82437,2237,626
12/5/2021,Indiana,6619680,315,82752,2283,626
12/6/2021,Indiana,6619680,294,83046,2434,662
12/7/2021,Indiana,6619680,393,83439,2501,670
12/8/2021,Indiana,6619680,372,83811,2547,671
12/9/2021,Indiana,6619680,382,84193,2585,667
12/10/2021,Indiana,6619680,362,84555,2591,688
12/11/2021,Indiana,6619680,369,84924,2584,712
12/12/2021,Indiana,6619680,314,85238,2628,721
12/13/2021,Indiana,6619680,293,85531,2782,760
12/14/2021,Indiana,6619680,377,85908,2814,768
12/15/2021,Indiana,6619680,373,86281,2804,763
12/16/2021,Indiana,6619680,395,86676,2797,753
12/17/2021,Indiana,6619680,382,87058,2783,766
12/18/2021,Indiana,6619680,361,87419,2754,776
12/19/2021,Indiana,6619680,341,87760,2807,757
12/20/2021,Indiana,6619680,318,88078,2787,778
12/21/2021,Indiana,6619680,377,88455,2731,761
12/22/2021,Indiana,6619680,363,88818,2740,792
12/23/2021,Indiana,6619680,359,89177,2650,758
12/24/2021,Indiana,6619680,380,89557,2714,775
12/25/2021,Indiana,6619680,309,89866,2703,777
12/26/2021,Indiana,6619680,291,90157,2748,781
12/27/2021,Indiana,6619680,303,90460,2797,784
12/28/2021,Indiana,6619680,412,90872,2759,754
12/29/2021,Indiana,6619680,402,91274,2807,744
12/30/2021,Indiana,6619680,421,91695,2809,736
12/31/2021,Indiana,6619680,411,92106,2791,682
1/1/2022,Indiana,6619680,382,92488,2835,714
1/2/2022,Indiana,6619680,387,92875,2934,733
1/3/2022,Indiana,6619680,344,93219,2892,732
1/4/2022,Indiana,6619680,472,93691,2997,719
1/5/2022,Indiana,6619680,458,94149,3037,736
1/6/2022,Indiana,6619680,474,94623,3087,729
1/7/2022,Indiana,6619680,511,95134,3164,767
1/8/2022,Indiana,6619680,485,95619,3117,753
1/9/2022,Indiana,6619680,428,96047,3128,751
1/10/2022,Indiana,6619680,361,96408,3196,757
1/11/2022,Indiana,6619680,493,96901,3227,777
1/12/2022,Indiana,6619680,478,97379,3238,739
1/13/2022,Indiana,6619680,517,97896,3236,748
1/14/2022,Indiana,6619680,510,98406,3200,720
1/15/2022,Indiana,6619680,487,98893,3090,698
1/16/2022,Indiana,6619680,397,99290,3034,689
1/17/2022,Indiana,6619680,397,99687,3186,716
1/18/2022,Indiana,6619680,475,100162,3215,699
1/19/2022,Indiana,6619680,490,100652,3181,697
1/20/2022,Indiana,6619680,484,101136,3130,651
1/21/2022,Indiana,6619680,455,101591,3037,635
1/22/2022,Indiana,6619680,422,102013,2922,631
1/23/2022,Indiana,6619680,355,102368,2878,634
1/24/2022,Indiana,6619680,349,102717,2895,645
1/25/2022,Indiana,6619680,375,103092,2883,624
1/26/2022,Indiana,6619680,365,103457,2762,608
1/27/2022,Indiana,6619680,409,103866,2663,602
1/28/2022,Indiana,6619680,378,104244,2584,577
1/29/2022,Indiana,6619680,317,104561,2461,548
1/30/2022,Indiana,6619680,285,104846,2441,548
1/31/2022,Indiana,6619680,283,105129,2484,529
2/1/2022,Indiana,6619680,336,105465,2417,537
2/2/2022,Indiana,6619680,362,105827,2373,524
2/3/2022,Indiana,6619680,293,106120,2272,500
2/4/2022,Indiana,6619680,262,106382,2248,482
2/5/2022,Indiana,6619680,276,106658,2112,456
2/6/2022,Indiana,6619680,237,106895,2032,443
2/7/2022,Indiana,6619680,212,107107,1851,396
2/8/2022,Indiana,6619680,278,107385,1896,410
2/9/2022,Indiana,6619680,278,107663,1896,410
7/1/2021,Kansas,2911641,14,22690,123,51
7/2/2021,Kansas,2911641,16,22706,115,49
7/3/2021,Kansas,2911641,19,22725,126,51
7/4/2021,Kansas,2911641,19,22744,129,55
7/5/2021,Kansas,2911641,20,22764,131,56
7/6/2021,Kansas,2911641,15,22779,128,50
7/7/2021,Kansas,2911641,27,22806,144,54
7/8/2021,Kansas,2911641,27,22833,157,56
7/9/2021,Kansas,2911641,27,22860,173,59
7/10/2021,Kansas,2911641,30,22890,179,63
7/11/2021,Kansas,2911641,27,22917,183,65
7/12/2021,Kansas,2911641,35,22952,216,69
7/13/2021,Kansas,2911641,47,22999,241,73
7/14/2021,Kansas,2911641,31,23030,252,76
7/15/2021,Kansas,2911641,57,23087,264,88
7/16/2021,Kansas,2911641,42,23129,267,90
7/17/2021,Kansas,2911641,60,23189,294,100
7/18/2021,Kansas,2911641,42,23231,309,108
7/19/2021,Kansas,2911641,48,23279,344,114
7/20/2021,Kansas,2911641,47,23326,335,109
7/21/2021,Kansas,2911641,48,23374,357,112
7/22/2021,Kansas,2911641,48,23422,341,105
7/23/2021,Kansas,2911641,57,23479,351,118
7/24/2021,Kansas,2911641,73,23552,369,118
7/25/2021,Kansas,2911641,50,23602,392,122
7/26/2021,Kansas,2911641,56,23658,400,122
7/27/2021,Kansas,2911641,68,23726,410,128
7/28/2021,Kansas,2911641,71,23797,413,130
7/29/2021,Kansas,2911641,82,23879,429,134
7/30/2021,Kansas,2911641,73,23952,427,145
7/31/2021,Kansas,2911641,68,24020,430,135
8/1/2021,Kansas,2911641,57,24077,431,132
8/2/2021,Kansas,2911641,85,24162,469,148
8/3/2021,Kansas,2911641,77,24239,485,150
8/4/2021,Kansas,2911641,73,24312,482,159
8/5/2021,Kansas,2911641,77,24389,484,157
8/6/2021,Kansas,2911641,90,24479,494,161
8/7/2021,Kansas,2911641,113,24592,552,176
8/8/2021,Kansas,2911641,76,24668,556,174
8/9/2021,Kansas,2911641,93,24761,597,186
8/10/2021,Kansas,2911641,103,24864,631,192
8/11/2021,Kansas,2911641,93,24957,606,193
8/12/2021,Kansas,2911641,113,25070,625,203
8/13/2021,Kansas,2911641,93,25163,606,199
8/14/2021,Kansas,2911641,94,25257,600,200
8/15/2021,Kansas,2911641,80,25337,607,205
8/16/2021,Kansas,2911641,91,25428,659,207
8/17/2021,Kansas,2911641,104,25532,672,200
8/18/2021,Kansas,2911641,129,25661,719,222
8/19/2021,Kansas,2911641,91,25752,732,226
8/20/2021,Kansas,2911641,114,25866,750,240
8/21/2021,Kansas,2911641,109,25975,725,233
8/22/2021,Kansas,2911641,84,26059,712,228
8/23/2021,Kansas,2911641,78,26137,718,222
8/24/2021,Kansas,2911641,111,26248,738,217
8/25/2021,Kansas,2911641,119,26367,738,233
8/26/2021,Kansas,2911641,114,26481,740,236
8/27/2021,Kansas,2911641,96,26577,718,233
8/28/2021,Kansas,2911641,98,26675,727,227
8/29/2021,Kansas,2911641,83,26758,731,240
8/30/2021,Kansas,2911641,104,26862,730,240
8/31/2021,Kansas,2911641,103,26965,735,246
9/1/2021,Kansas,2911641,102,27067,731,241
9/2/2021,Kansas,2911641,105,27172,725,225
9/3/2021,Kansas,2911641,111,27283,737,227
9/4/2021,Kansas,2911641,87,27370,718,211
9/5/2021,Kansas,2911641,96,27466,728,221
9/6/2021,Kansas,2911641,85,27551,702,210
9/7/2021,Kansas,2911641,112,27663,734,216
9/8/2021,Kansas,2911641,116,27779,685,222
9/9/2021,Kansas,2911641,101,27880,698,224
9/10/2021,Kansas,2911641,114,27994,701,228
9/11/2021,Kansas,2911641,106,28100,666,218
9/12/2021,Kansas,2911641,95,28195,670,215
9/13/2021,Kansas,2911641,95,28290,672,217
9/14/2021,Kansas,2911641,103,28393,659,203
9/15/2021,Kansas,2911641,95,28488,658,210
9/16/2021,Kansas,2911641,89,28577,646,209
9/17/2021,Kansas,2911641,83,28660,629,206
9/18/2021,Kansas,2911641,93,28753,617,203
9/19/2021,Kansas,2911641,73,28826,595,198
9/20/2021,Kansas,2911641,77,28903,612,204
9/21/2021,Kansas,2911641,96,28999,606,201
9/22/2021,Kansas,2911641,101,29100,635,215
9/23/2021,Kansas,2911641,77,29177,621,202
9/24/2021,Kansas,2911641,84,29261,577,198
9/25/2021,Kansas,2911641,96,29357,554,192
9/26/2021,Kansas,2911641,61,29418,557,188
9/27/2021,Kansas,2911641,77,29495,569,182
9/28/2021,Kansas,2911641,76,29571,556,181
9/29/2021,Kansas,2911641,78,29649,540,180
9/30/2021,Kansas,2911641,86,29735,538,172
10/1/2021,Kansas,2911641,86,29821,536,163
10/2/2021,Kansas,2911641,67,29888,516,164
10/3/2021,Kansas,2911641,52,29940,521,168
10/4/2021,Kansas,2911641,67,30007,517,159
10/5/2021,Kansas,2911641,71,30078,508,160
10/6/2021,Kansas,2911641,70,30148,496,157
10/7/2021,Kansas,2911641,57,30205,473,155
10/8/2021,Kansas,2911641,70,30275,468,150
10/9/2021,Kansas,2911641,65,30340,448,141
10/10/2021,Kansas,2911641,58,30398,458,136
10/11/2021,Kansas,2911641,58,30456,463,136
10/12/2021,Kansas,2911641,80,30536,469,139
10/13/2021,Kansas,2911641,70,30606,455,137
10/14/2021,Kansas,2911641,55,30661,441,129
10/15/2021,Kansas,2911641,81,30742,435,139
10/16/2021,Kansas,2911641,56,30798,424,123
10/17/2021,Kansas,2911641,74,30872,425,118
10/18/2021,Kansas,2911641,55,30927,440,128
10/19/2021,Kansas,2911641,66,30993,440,130
10/20/2021,Kansas,2911641,54,31047,415,130
10/21/2021,Kansas,2911641,67,31114,408,133
10/22/2021,Kansas,2911641,42,31156,392,129
10/23/2021,Kansas,2911641,55,31211,380,125
10/24/2021,Kansas,2911641,58,31269,397,127
10/25/2021,Kansas,2911641,60,31329,425,124
10/26/2021,Kansas,2911641,67,31396,434,121
10/27/2021,Kansas,2911641,64,31460,427,125
10/28/2021,Kansas,2911641,55,31515,420,120
10/29/2021,Kansas,2911641,44,31559,388,119
10/30/2021,Kansas,2911641,45,31604,382,119
10/31/2021,Kansas,2911641,45,31649,377,122
11/1/2021,Kansas,2911641,48,31697,395,121
11/2/2021,Kansas,2911641,49,31746,381,115
11/3/2021,Kansas,2911641,55,31801,379,106
11/4/2021,Kansas,2911641,60,31861,377,100
11/5/2021,Kansas,2911641,65,31926,386,99
11/6/2021,Kansas,2911641,72,31998,368,107
11/7/2021,Kansas,2911641,53,32051,371,114
11/8/2021,Kansas,2911641,71,32122,381,114
11/9/2021,Kansas,2911641,80,32202,384,117
11/10/2021,Kansas,2911641,74,32276,400,109
11/11/2021,Kansas,2911641,66,32342,402,111
11/12/2021,Kansas,2911641,56,32398,386,107
11/13/2021,Kansas,2911641,68,32466,400,110
11/14/2021,Kansas,2911641,60,32526,401,120
11/15/2021,Kansas,2911641,57,32583,418,118
11/16/2021,Kansas,2911641,80,32663,435,118
11/17/2021,Kansas,2911641,84,32747,439,114
11/18/2021,Kansas,2911641,75,32822,445,119
11/19/2021,Kansas,2911641,86,32908,459,134
11/20/2021,Kansas,2911641,81,32989,459,130
11/21/2021,Kansas,2911641,77,33066,472,133
11/22/2021,Kansas,2911641,57,33123,469,131
11/23/2021,Kansas,2911641,88,33211,461,139
11/24/2021,Kansas,2911641,104,33315,482,134
11/25/2021,Kansas,2911641,92,33407,454,140
11/26/2021,Kansas,2911641,66,33473,462,139
11/27/2021,Kansas,2911641,83,33556,492,140
11/28/2021,Kansas,2911641,82,33638,538,146
11/29/2021,Kansas,2911641,94,33732,547,141
11/30/2021,Kansas,2911641,108,33840,573,145
12/1/2021,Kansas,2911641,104,33944,591,148
12/2/2021,Kansas,2911641,95,34039,591,167
12/3/2021,Kansas,2911641,111,34150,625,181
12/4/2021,Kansas,2911641,98,34248,628,191
12/5/2021,Kansas,2911641,85,34333,625,185
12/6/2021,Kansas,2911641,99,34432,660,194
12/7/2021,Kansas,2911641,105,34537,645,198
12/8/2021,Kansas,2911641,106,34643,658,190
12/9/2021,Kansas,2911641,104,34747,668,197
12/10/2021,Kansas,2911641,130,34877,707,192
12/11/2021,Kansas,2911641,112,34989,698,186
12/12/2021,Kansas,2911641,78,35067,703,185
12/13/2021,Kansas,2911641,88,35155,708,195
12/14/2021,Kansas,2911641,105,35260,714,193
12/15/2021,Kansas,2911641,119,35379,735,198
12/16/2021,Kansas,2911641,108,35487,737,205
12/17/2021,Kansas,2911641,112,35599,752,208
12/18/2021,Kansas,2911641,105,35704,726,208
12/19/2021,Kansas,2911641,103,35807,734,216
12/20/2021,Kansas,2911641,98,35905,762,228
12/21/2021,Kansas,2911641,103,36008,764,234
12/22/2021,Kansas,2911641,117,36125,753,236
12/23/2021,Kansas,2911641,104,36229,740,232
12/24/2021,Kansas,2911641,116,36345,734,228
12/25/2021,Kansas,2911641,98,36443,734,234
12/26/2021,Kansas,2911641,97,36540,766,242
12/27/2021,Kansas,2911641,125,36665,804,232
12/28/2021,Kansas,2911641,125,36790,822,239
12/29/2021,Kansas,2911641,138,36928,837,238
12/30/2021,Kansas,2911641,113,37041,826,218
12/31/2021,Kansas,2911641,134,37175,850,231
1/1/2022,Kansas,2911641,135,37310,853,209
1/2/2022,Kansas,2911641,116,37426,852,208
1/3/2022,Kansas,2911641,112,37538,883,225
1/4/2022,Kansas,2911641,156,37694,931,236
1/5/2022,Kansas,2911641,166,37860,960,241
1/6/2022,Kansas,2911641,177,38037,1000,240
1/7/2022,Kansas,2911641,178,38215,1043,255
1/8/2022,Kansas,2911641,126,38341,1049,231
1/9/2022,Kansas,2911641,163,38504,1050,241
1/10/2022,Kansas,2911641,146,38650,1085,259
1/11/2022,Kansas,2911641,176,38826,1127,259
1/12/2022,Kansas,2911641,184,39010,1182,260
1/13/2022,Kansas,2911641,208,39218,1180,260
1/14/2022,Kansas,2911641,215,39433,1215,273
1/15/2022,Kansas,2911641,182,39615,1176,264
1/16/2022,Kansas,2911641,159,39774,1212,266
1/17/2022,Kansas,2911641,161,39935,1192,278
1/18/2022,Kansas,2911641,215,40150,1226,278
1/19/2022,Kansas,2911641,247,40397,1275,276
1/20/2022,Kansas,2911641,210,40607,1273,280
1/21/2022,Kansas,2911641,223,40830,1256,275
1/22/2022,Kansas,2911641,197,41027,1178,271
1/23/2022,Kansas,2911641,158,41185,1176,253
1/24/2022,Kansas,2911641,163,41348,1194,253
1/25/2022,Kansas,2911641,200,41548,1202,250
1/26/2022,Kansas,2911641,199,41747,1199,251
1/27/2022,Kansas,2911641,173,41920,1176,251
1/28/2022,Kansas,2911641,179,42099,1161,245
1/29/2022,Kansas,2911641,167,42266,1093,240
1/30/2022,Kansas,2911641,129,42395,1077,233
1/31/2022,Kansas,2911641,123,42518,1106,243
2/1/2022,Kansas,2911641,151,42669,1056,240
2/2/2022,Kansas,2911641,145,42814,1016,231
2/3/2022,Kansas,2911641,121,42935,999,229
2/4/2022,Kansas,2911641,127,43062,957,213
2/5/2022,Kansas,2911641,119,43181,893,205
2/6/2022,Kansas,2911641,92,43273,864,197
2/7/2022,Kansas,2911641,99,43372,884,194
2/8/2022,Kansas,2911641,155,43527,874,197
2/9/2022,Kansas,2911641,149,43676,847,191
7/1/2021,Kentucky,4425092,73,78529,170,56
7/2/2021,Kentucky,4425092,60,78589,159,59
7/3/2021,Kentucky,4425092,80,78669,178,61
7/4/2021,Kentucky,4425092,69,78738,173,61
7/5/2021,Kentucky,4425092,69,78807,180,66
7/6/2021,Kentucky,4425092,70,78877,194,64
7/7/2021,Kentucky,4425092,78,78955,202,64
7/8/2021,Kentucky,4425092,77,79032,191,68
7/9/2021,Kentucky,4425092,73,79105,183,70
7/10/2021,Kentucky,4425092,85,79190,183,63
7/11/2021,Kentucky,4425092,78,79268,181,62
7/12/2021,Kentucky,4425092,86,79354,195,55
7/13/2021,Kentucky,4425092,94,79448,205,59
7/14/2021,Kentucky,4425092,89,79537,228,59
7/15/2021,Kentucky,4425092,98,79635,254,63
7/16/2021,Kentucky,4425092,112,79747,260,78
7/17/2021,Kentucky,4425092,102,79849,274,88
7/18/2021,Kentucky,4425092,91,79940,295,90
7/19/2021,Kentucky,4425092,66,80006,308,103
7/20/2021,Kentucky,4425092,110,80116,337,102
7/21/2021,Kentucky,4425092,89,80205,355,111
7/22/2021,Kentucky,4425092,88,80293,370,120
7/23/2021,Kentucky,4425092,119,80412,382,128
7/24/2021,Kentucky,4425092,135,80547,415,146
7/25/2021,Kentucky,4425092,122,80669,435,154
7/26/2021,Kentucky,4425092,135,80804,475,166
7/27/2021,Kentucky,4425092,153,80957,508,178
7/28/2021,Kentucky,4425092,175,81132,548,183
7/29/2021,Kentucky,4425092,156,81288,555,187
7/30/2021,Kentucky,4425092,183,81471,600,196
7/31/2021,Kentucky,4425092,215,81686,670,210
8/1/2021,Kentucky,4425092,186,81872,712,233
8/2/2021,Kentucky,4425092,203,82075,747,237
8/3/2021,Kentucky,4425092,234,82309,795,254
8/4/2021,Kentucky,4425092,270,82579,842,256
8/5/2021,Kentucky,4425092,292,82871,863,267
8/6/2021,Kentucky,4425092,262,83133,934,295
8/7/2021,Kentucky,4425092,275,83408,976,297
8/8/2021,Kentucky,4425092,252,83660,1018,301
8/9/2021,Kentucky,4425092,307,83967,1115,309
8/10/2021,Kentucky,4425092,360,84327,1233,352
8/11/2021,Kentucky,4425092,355,84682,1286,353
8/12/2021,Kentucky,4425092,360,85042,1355,390
8/13/2021,Kentucky,4425092,360,85402,1380,389
8/14/2021,Kentucky,4425092,337,85739,1380,404
8/15/2021,Kentucky,4425092,332,86071,1426,419
8/16/2021,Kentucky,4425092,420,86491,1525,433
8/17/2021,Kentucky,4425092,435,86926,1561,449
8/18/2021,Kentucky,4425092,453,87379,1612,471
8/19/2021,Kentucky,4425092,448,87827,1654,471
8/20/2021,Kentucky,4425092,450,88277,1696,479
8/21/2021,Kentucky,4425092,443,88720,1734,469
8/22/2021,Kentucky,4425092,436,89156,1785,488
8/23/2021,Kentucky,4425092,447,89603,1885,503
8/24/2021,Kentucky,4425092,524,90127,1937,544
8/25/2021,Kentucky,4425092,538,90665,1977,545
8/26/2021,Kentucky,4425092,511,91176,1982,541
8/27/2021,Kentucky,4425092,507,91683,2040,572
8/28/2021,Kentucky,4425092,462,92145,2009,581
8/29/2021,Kentucky,4425092,504,92649,2097,587
8/30/2021,Kentucky,4425092,521,93170,2158,596
8/31/2021,Kentucky,4425092,557,93727,2134,602
9/1/2021,Kentucky,4425092,619,94346,2215,596
9/2/2021,Kentucky,4425092,601,94947,2231,628
9/3/2021,Kentucky,4425092,545,95492,2214,641
9/4/2021,Kentucky,4425092,583,96075,2199,601
9/5/2021,Kentucky,4425092,550,96625,2233,615
9/6/2021,Kentucky,4425092,583,97208,2237,634
9/7/2021,Kentucky,4425092,592,97800,2308,651
9/8/2021,Kentucky,4425092,655,98455,2380,644
9/9/2021,Kentucky,4425092,612,99067,2393,644
9/10/2021,Kentucky,4425092,587,99654,2393,626
9/11/2021,Kentucky,4425092,638,100292,2360,613
9/12/2021,Kentucky,4425092,565,100857,2381,627
9/13/2021,Kentucky,4425092,585,101442,2402,649
9/14/2021,Kentucky,4425092,608,102050,2390,641
9/15/2021,Kentucky,4425092,467,102517,2350,638
9/16/2021,Kentucky,4425092,446,102963,2301,617
9/17/2021,Kentucky,4425092,460,103423,2245,627
9/18/2021,Kentucky,4425092,326,103749,2199,641
9/19/2021,Kentucky,4425092,324,104073,2165,634
9/20/2021,Kentucky,4425092,308,104381,2157,639
9/21/2021,Kentucky,4425092,335,104716,2127,629
9/22/2021,Kentucky,4425092,351,105067,2144,601
9/23/2021,Kentucky,4425092,297,105364,2099,604
9/24/2021,Kentucky,4425092,240,105604,2059,585
9/25/2021,Kentucky,4425092,159,105763,1944,576
9/26/2021,Kentucky,4425092,143,105906,1917,579
9/27/2021,Kentucky,4425092,238,106144,1879,555
9/28/2021,Kentucky,4425092,307,106451,1881,536
9/29/2021,Kentucky,4425092,262,106713,1859,526
9/30/2021,Kentucky,4425092,227,106940,1786,510
10/1/2021,Kentucky,4425092,214,107154,1712,457
10/2/2021,Kentucky,4425092,194,107348,1602,459
10/3/2021,Kentucky,4425092,176,107524,1562,452
10/4/2021,Kentucky,4425092,211,107735,1568,453
10/5/2021,Kentucky,4425092,205,107940,1536,434
10/6/2021,Kentucky,4425092,223,108163,1499,437
10/7/2021,Kentucky,4425092,196,108359,1424,414
10/8/2021,Kentucky,4425092,177,108536,1309,395
10/9/2021,Kentucky,4425092,114,108650,1294,388
10/10/2021,Kentucky,4425092,122,108772,1295,379
10/11/2021,Kentucky,4425092,90,108862,1271,367
10/12/2021,Kentucky,4425092,135,108997,1285,369
10/13/2021,Kentucky,4425092,194,109191,1285,379
10/14/2021,Kentucky,4425092,164,109355,1205,338
10/15/2021,Kentucky,4425092,165,109520,1169,332
10/16/2021,Kentucky,4425092,174,109694,1163,329
10/17/2021,Kentucky,4425092,121,109815,1117,318
10/18/2021,Kentucky,4425092,152,109967,1103,327
10/19/2021,Kentucky,4425092,153,110120,1036,296
10/20/2021,Kentucky,4425092,154,110274,1033,298
10/21/2021,Kentucky,4425092,140,110414,956,269
10/22/2021,Kentucky,4425092,158,110572,912,272
10/23/2021,Kentucky,4425092,90,110662,895,259
10/24/2021,Kentucky,4425092,75,110737,859,258
10/25/2021,Kentucky,4425092,128,110865,835,244
10/26/2021,Kentucky,4425092,119,110984,804,256
10/27/2021,Kentucky,4425092,136,111120,806,250
10/28/2021,Kentucky,4425092,137,111257,800,251
10/29/2021,Kentucky,4425092,136,111393,774,234
10/30/2021,Kentucky,4425092,107,111500,717,217
10/31/2021,Kentucky,4425092,88,111588,694,212
11/1/2021,Kentucky,4425092,105,111693,720,213
11/2/2021,Kentucky,4425092,124,111817,707,206
11/3/2021,Kentucky,4425092,117,111934,720,197
11/4/2021,Kentucky,4425092,96,112030,681,194
11/5/2021,Kentucky,4425092,103,112133,661,181
11/6/2021,Kentucky,4425092,71,112204,627,173
11/7/2021,Kentucky,4425092,96,112300,638,186
11/8/2021,Kentucky,4425092,59,112359,632,169
11/9/2021,Kentucky,4425092,103,112462,628,170
11/10/2021,Kentucky,4425092,130,112592,653,175
11/11/2021,Kentucky,4425092,96,112688,642,184
11/12/2021,Kentucky,4425092,121,112809,679,191
11/13/2021,Kentucky,4425092,104,112913,656,175
11/14/2021,Kentucky,4425092,96,113009,642,182
11/15/2021,Kentucky,4425092,123,113132,672,193
11/16/2021,Kentucky,4425092,137,113269,678,185
11/17/2021,Kentucky,4425092,127,113396,681,187
11/18/2021,Kentucky,4425092,127,113523,702,187
11/19/2021,Kentucky,4425092,112,113635,700,187
11/20/2021,Kentucky,4425092,145,113780,692,184
11/21/2021,Kentucky,4425092,91,113871,729,188
11/22/2021,Kentucky,4425092,88,113959,763,212
11/23/2021,Kentucky,4425092,152,114111,774,195
11/24/2021,Kentucky,4425092,149,114260,765,194
11/25/2021,Kentucky,4425092,133,114393,753,191
11/26/2021,Kentucky,4425092,117,114510,721,205
11/27/2021,Kentucky,4425092,142,114652,758,215
11/28/2021,Kentucky,4425092,132,114784,774,225
11/29/2021,Kentucky,4425092,137,114921,817,234
11/30/2021,Kentucky,4425092,166,115087,853,237
12/1/2021,Kentucky,4425092,187,115274,878,245
12/2/2021,Kentucky,4425092,151,115425,868,263
12/3/2021,Kentucky,4425092,178,115603,918,271
12/4/2021,Kentucky,4425092,159,115762,957,282
12/5/2021,Kentucky,4425092,121,115883,989,295
12/6/2021,Kentucky,4425092,157,116040,1032,290
12/7/2021,Kentucky,4425092,188,116228,1051,295
12/8/2021,Kentucky,4425092,200,116428,1092,304
12/9/2021,Kentucky,4425092,215,116643,1109,310
12/10/2021,Kentucky,4425092,193,116836,1113,314
12/11/2021,Kentucky,4425092,201,117037,1126,313
12/12/2021,Kentucky,4425092,167,117204,1145,300
12/13/2021,Kentucky,4425092,178,117382,1140,301
12/14/2021,Kentucky,4425092,199,117581,1143,312
12/15/2021,Kentucky,4425092,218,117799,1154,298
12/16/2021,Kentucky,4425092,200,117999,1151,312
12/17/2021,Kentucky,4425092,180,118179,1149,299
12/18/2021,Kentucky,4425092,168,118347,1126,304
12/19/2021,Kentucky,4425092,159,118506,1129,306
12/20/2021,Kentucky,4425092,174,118680,1128,308
12/21/2021,Kentucky,4425092,224,118904,1121,307
12/22/2021,Kentucky,4425092,175,119079,1151,332
12/23/2021,Kentucky,4425092,213,119292,1151,314
12/24/2021,Kentucky,4425092,176,119468,1100,317
12/25/2021,Kentucky,4425092,178,119646,1076,317
12/26/2021,Kentucky,4425092,187,119833,1118,323
12/27/2021,Kentucky,4425092,140,119973,1207,333
12/28/2021,Kentucky,4425092,243,120216,1325,347
12/29/2021,Kentucky,4425092,255,120471,1414,350
12/30/2021,Kentucky,4425092,250,120721,1377,337
12/31/2021,Kentucky,4425092,263,120984,1415,323
1/1/2022,Kentucky,4425092,233,121217,1384,309
1/2/2022,Kentucky,4425092,261,121478,1476,341
1/3/2022,Kentucky,4425092,294,121772,1529,361
1/4/2022,Kentucky,4425092,285,122057,1576,357
1/5/2022,Kentucky,4425092,351,122408,1683,361
1/6/2022,Kentucky,4425092,345,122753,1738,402
1/7/2022,Kentucky,4425092,295,123048,1748,392
1/8/2022,Kentucky,4425092,191,123239,1729,398
1/9/2022,Kentucky,4425092,205,123444,1762,411
1/10/2022,Kentucky,4425092,340,123784,1826,414
1/11/2022,Kentucky,4425092,357,124141,1891,418
1/12/2022,Kentucky,4425092,445,124586,2064,432
1/13/2022,Kentucky,4425092,287,124873,2069,438
1/14/2022,Kentucky,4425092,379,125252,2071,415
1/15/2022,Kentucky,4425092,387,125639,2068,421
1/16/2022,Kentucky,4425092,387,126026,2082,423
1/17/2022,Kentucky,4425092,420,126446,2117,413
1/18/2022,Kentucky,4425092,444,126890,2177,440
1/19/2022,Kentucky,4425092,565,127455,2402,420
1/20/2022,Kentucky,4425092,490,127945,2350,419
1/21/2022,Kentucky,4425092,447,128392,2379,444
1/22/2022,Kentucky,4425092,301,128693,2355,429
1/23/2022,Kentucky,4425092,277,128970,2379,454
1/24/2022,Kentucky,4425092,436,129406,2363,441
1/25/2022,Kentucky,4425092,478,129884,2452,454
1/26/2022,Kentucky,4425092,570,130454,2573,458
1/27/2022,Kentucky,4425092,491,130945,2497,436
1/28/2022,Kentucky,4425092,508,131453,2512,442
1/29/2022,Kentucky,4425092,448,131901,2471,448
1/30/2022,Kentucky,4425092,435,132336,2460,444
1/31/2022,Kentucky,4425092,375,132711,2389,433
2/1/2022,Kentucky,4425092,468,133179,2419,436
2/2/2022,Kentucky,4425092,451,133630,2428,440
2/3/2022,Kentucky,4425092,406,134036,2314,407
2/4/2022,Kentucky,4425092,373,134409,2263,408
2/5/2022,Kentucky,4425092,230,134639,2183,401
2/6/2022,Kentucky,4425092,275,134914,2153,407
2/7/2022,Kentucky,4425092,331,135245,2118,416
2/8/2022,Kentucky,4425092,379,135624,2126,389
2/9/2022,Kentucky,4425092,379,136003,2126,389
7/1/2021,Louisiana,4533372,43,39825,311,78
7/2/2021,Louisiana,4533372,59,39884,326,76
7/3/2021,Louisiana,4533372,63,39947,349,77
7/4/2021,Louisiana,4533372,60,40007,369,89
7/5/2021,Louisiana,4533372,51,40058,388,87
7/6/2021,Louisiana,4533372,65,40123,412,90
7/7/2021,Louisiana,4533372,73,40196,400,97
7/8/2021,Louisiana,4533372,179,40375,421,103
7/9/2021,Louisiana,4533372,85,40460,449,97
7/10/2021,Louisiana,4533372,79,40539,450,103
7/11/2021,Louisiana,4533372,75,40614,461,107
7/12/2021,Louisiana,4533372,85,40699,503,123
7/13/2021,Louisiana,4533372,105,40804,528,117
7/14/2021,Louisiana,4533372,101,40905,555,124
7/15/2021,Louisiana,4533372,117,41022,616,137
7/16/2021,Louisiana,4533372,130,41152,643,147
7/17/2021,Louisiana,4533372,133,41285,677,154
7/18/2021,Louisiana,4533372,147,41432,744,170
7/19/2021,Louisiana,4533372,157,41589,815,180
7/20/2021,Louisiana,4533372,183,41772,875,198
7/21/2021,Louisiana,4533372,179,41951,947,200
7/22/2021,Louisiana,4533372,223,42174,1032,233
7/23/2021,Louisiana,4533372,206,42380,1105,261
7/24/2021,Louisiana,4533372,225,42605,1207,284
7/25/2021,Louisiana,4533372,208,42813,1266,295
7/26/2021,Louisiana,4533372,245,43058,1420,332
7/27/2021,Louisiana,4533372,306,43364,1566,365
7/28/2021,Louisiana,4533372,276,43640,1671,378
7/29/2021,Louisiana,4533372,295,43935,1789,430
7/30/2021,Louisiana,4533372,313,44248,1860,462
7/31/2021,Louisiana,4533372,370,44618,1928,560
8/1/2021,Louisiana,4533372,319,44937,2012,582
8/2/2021,Louisiana,4533372,425,45362,2159,651
8/3/2021,Louisiana,4533372,440,45802,2249,670
8/4/2021,Louisiana,4533372,406,46208,2359,721
8/5/2021,Louisiana,4533372,421,46629,2457,746
8/6/2021,Louisiana,4533372,449,47078,2616,766
8/7/2021,Louisiana,4533372,425,47503,2579,769
8/8/2021,Louisiana,4533372,443,47946,2725,806
8/9/2021,Louisiana,4533372,424,48370,2851,823
8/10/2021,Louisiana,4533372,414,48784,2969,844
8/11/2021,Louisiana,4533372,419,49203,2962,855
8/12/2021,Louisiana,4533372,456,49659,2975,865
8/13/2021,Louisiana,4533372,426,50085,3012,875
8/14/2021,Louisiana,4533372,425,50510,3010,879
8/15/2021,Louisiana,4533372,340,50850,3030,886
8/16/2021,Louisiana,4533372,343,51193,3107,906
8/17/2021,Louisiana,4533372,417,51610,3122,914
8/18/2021,Louisiana,4533372,406,52016,3109,951
8/19/2021,Louisiana,4533372,409,52425,3035,946
8/20/2021,Louisiana,4533372,364,52789,3027,925
8/21/2021,Louisiana,4533372,364,53153,2942,935
8/22/2021,Louisiana,4533372,297,53450,2919,919
8/23/2021,Louisiana,4533372,250,53700,2945,906
8/24/2021,Louisiana,4533372,358,54058,2928,913
8/25/2021,Louisiana,4533372,312,54370,2781,881
8/26/2021,Louisiana,4533372,315,54685,2752,877
8/27/2021,Louisiana,4533372,236,54921,2615,858
8/28/2021,Louisiana,4533372,293,55214,2558,832
8/29/2021,Louisiana,4533372,229,55443,2492,823
8/30/2021,Louisiana,4533372,203,55646,2505,830
8/31/2021,Louisiana,4533372,264,55910,2516,817
9/1/2021,Louisiana,4533372,248,56158,2498,816
9/2/2021,Louisiana,4533372,206,56364,2355,781
9/3/2021,Louisiana,4533372,195,56559,2304,736
9/4/2021,Louisiana,4533372,206,56765,2195,701
9/5/2021,Louisiana,4533372,148,56913,2125,684
9/6/2021,Louisiana,4533372,166,57079,2119,674
9/7/2021,Louisiana,4533372,179,57258,1997,645
9/8/2021,Louisiana,4533372,179,57437,1909,632
9/9/2021,Louisiana,4533372,205,57642,1851,595
9/10/2021,Louisiana,4533372,190,57832,1811,572
9/11/2021,Louisiana,4533372,159,57991,1750,554
9/12/2021,Louisiana,4533372,172,58163,1755,553
9/13/2021,Louisiana,4533372,138,58301,1713,531
9/14/2021,Louisiana,4533372,151,58452,1634,518
9/15/2021,Louisiana,4533372,171,58623,1567,478
9/16/2021,Louisiana,4533372,137,58760,1509,471
9/17/2021,Louisiana,4533372,164,58924,1485,455
9/18/2021,Louisiana,4533372,150,59074,1429,419
9/19/2021,Louisiana,4533372,124,59198,1415,420
9/20/2021,Louisiana,4533372,107,59305,1367,408
9/21/2021,Louisiana,4533372,117,59422,1329,401
9/22/2021,Louisiana,4533372,103,59525,1297,378
9/23/2021,Louisiana,4533372,119,59644,1234,357
9/24/2021,Louisiana,4533372,106,59750,1192,338
9/25/2021,Louisiana,4533372,76,59826,1120,322
9/26/2021,Louisiana,4533372,88,59914,1093,308
9/27/2021,Louisiana,4533372,74,59988,1092,299
9/28/2021,Louisiana,4533372,83,60071,1064,309
9/29/2021,Louisiana,4533372,81,60152,1003,282
9/30/2021,Louisiana,4533372,73,60225,954,273
10/1/2021,Louisiana,4533372,80,60305,923,255
10/2/2021,Louisiana,4533372,72,60377,858,236
10/3/2021,Louisiana,4533372,61,60438,838,216
10/4/2021,Louisiana,4533372,45,60483,817,221
10/5/2021,Louisiana,4533372,67,60550,784,222
10/6/2021,Louisiana,4533372,71,60621,741,208
10/7/2021,Louisiana,4533372,63,60684,744,199
10/8/2021,Louisiana,4533372,73,60757,724,201
10/9/2021,Louisiana,4533372,62,60819,690,190
10/10/2021,Louisiana,4533372,48,60867,670,188
10/11/2021,Louisiana,4533372,46,60913,658,177
10/12/2021,Louisiana,4533372,53,60966,627,160
10/13/2021,Louisiana,4533372,61,61027,625,158
10/14/2021,Louisiana,4533372,65,61092,611,162
10/15/2021,Louisiana,4533372,63,61155,596,151
10/16/2021,Louisiana,4533372,45,61200,576,140
10/17/2021,Louisiana,4533372,46,61246,566,125
10/18/2021,Louisiana,4533372,39,61285,555,130
10/19/2021,Louisiana,4533372,63,61348,536,123
10/20/2021,Louisiana,4533372,43,61391,509,112
10/21/2021,Louisiana,4533372,45,61436,507,111
10/22/2021,Louisiana,4533372,36,61472,508,115
10/23/2021,Louisiana,4533372,46,61518,477,104
10/24/2021,Louisiana,4533372,32,61550,477,99
10/25/2021,Louisiana,4533372,29,61579,499,108
10/26/2021,Louisiana,4533372,30,61609,487,104
10/27/2021,Louisiana,4533372,34,61643,473,105
10/28/2021,Louisiana,4533372,37,61680,464,103
10/29/2021,Louisiana,4533372,38,61718,452,96
10/30/2021,Louisiana,4533372,28,61746,431,92
10/31/2021,Louisiana,4533372,26,61772,422,94
11/1/2021,Louisiana,4533372,18,61790,398,81
11/2/2021,Louisiana,4533372,27,61817,393,86
11/3/2021,Louisiana,4533372,37,61854,337,85
11/4/2021,Louisiana,4533372,38,61892,311,82
11/5/2021,Louisiana,4533372,29,61921,312,80
11/6/2021,Louisiana,4533372,31,61952,294,75
11/7/2021,Louisiana,4533372,26,61978,298,86
11/8/2021,Louisiana,4533372,27,62005,311,89
11/9/2021,Louisiana,4533372,35,62040,328,89
11/10/2021,Louisiana,4533372,25,62065,322,84
11/11/2021,Louisiana,4533372,24,62089,283,77
11/12/2021,Louisiana,4533372,27,62116,281,75
11/13/2021,Louisiana,4533372,28,62144,265,73
11/14/2021,Louisiana,4533372,30,62174,265,72
11/15/2021,Louisiana,4533372,30,62204,288,80
11/16/2021,Louisiana,4533372,27,62231,271,76
11/17/2021,Louisiana,4533372,34,62265,279,75
11/18/2021,Louisiana,4533372,32,62297,275,72
11/19/2021,Louisiana,4533372,31,62328,273,75
11/20/2021,Louisiana,4533372,33,62361,273,79
11/21/2021,Louisiana,4533372,26,62387,280,79
11/22/2021,Louisiana,4533372,23,62410,267,79
11/23/2021,Louisiana,4533372,40,62450,271,77
11/24/2021,Louisiana,4533372,26,62476,265,77
11/25/2021,Louisiana,4533372,46,62522,274,82
11/26/2021,Louisiana,4533372,34,62556,272,81
11/27/2021,Louisiana,4533372,33,62589,274,86
11/28/2021,Louisiana,4533372,23,62612,279,85
11/29/2021,Louisiana,4533372,33,62645,287,88
11/30/2021,Louisiana,4533372,49,62694,288,81
12/1/2021,Louisiana,4533372,33,62727,284,86
12/2/2021,Louisiana,4533372,40,62767,276,83
12/3/2021,Louisiana,4533372,32,62799,271,79
12/4/2021,Louisiana,4533372,30,62829,281,79
12/5/2021,Louisiana,4533372,20,62849,283,78
12/6/2021,Louisiana,4533372,25,62874,281,75
12/7/2021,Louisiana,4533372,38,62912,274,62
12/8/2021,Louisiana,4533372,33,62945,284,62
12/9/2021,Louisiana,4533372,30,62975,311,60
12/10/2021,Louisiana,4533372,38,63013,318,64
12/11/2021,Louisiana,4533372,27,63040,278,63
12/12/2021,Louisiana,4533372,23,63063,266,64
12/13/2021,Louisiana,4533372,27,63090,259,59
12/14/2021,Louisiana,4533372,39,63129,270,64
12/15/2021,Louisiana,4533372,51,63180,265,68
12/16/2021,Louisiana,4533372,27,63207,268,64
12/17/2021,Louisiana,4533372,42,63249,279,69
12/18/2021,Louisiana,4533372,48,63297,288,70
12/19/2021,Louisiana,4533372,50,63347,299,69
12/20/2021,Louisiana,4533372,56,63403,327,75
12/21/2021,Louisiana,4533372,48,63451,328,75
12/22/2021,Louisiana,4533372,49,63500,361,68
12/23/2021,Louisiana,4533372,118,63618,381,70
12/24/2021,Louisiana,4533372,120,63738,417,76
12/25/2021,Louisiana,4533372,103,63841,459,92
12/26/2021,Louisiana,4533372,106,63947,487,87
12/27/2021,Louisiana,4533372,86,64033,576,112
12/28/2021,Louisiana,4533372,203,64236,729,127
12/29/2021,Louisiana,4533372,228,64464,836,146
12/30/2021,Louisiana,4533372,162,64626,928,148
12/31/2021,Louisiana,4533372,196,64822,1020,166
1/1/2022,Louisiana,4533372,258,65080,1072,167
1/2/2022,Louisiana,4533372,196,65276,1183,190
1/3/2022,Louisiana,4533372,255,65531,1268,189
1/4/2022,Louisiana,4533372,329,65860,1332,202
1/5/2022,Louisiana,4533372,350,66210,1441,238
1/6/2022,Louisiana,4533372,365,66575,1542,246
1/7/2022,Louisiana,4533372,272,66847,1639,276
1/8/2022,Louisiana,4533372,381,67228,1742,310
1/9/2022,Louisiana,4533372,290,67518,1821,349
1/10/2022,Louisiana,4533372,323,67841,1939,390
1/11/2022,Louisiana,4533372,342,68183,2031,394
1/12/2022,Louisiana,4533372,410,68593,2102,414
1/13/2022,Louisiana,4533372,419,69012,2132,432
1/14/2022,Louisiana,4533372,368,69380,2075,418
1/15/2022,Louisiana,4533372,391,69771,2081,404
1/16/2022,Louisiana,4533372,337,70108,2125,403
1/17/2022,Louisiana,4533372,273,70381,2051,424
1/18/2022,Louisiana,4533372,337,70718,2186,444
1/19/2022,Louisiana,4533372,440,71158,2233,447
1/20/2022,Louisiana,4533372,386,71544,2189,434
1/21/2022,Louisiana,4533372,337,71881,2109,430
1/22/2022,Louisiana,4533372,315,72196,2050,419
1/23/2022,Louisiana,4533372,289,72485,2039,422
1/24/2022,Louisiana,4533372,322,72807,2086,435
1/25/2022,Louisiana,4533372,332,73139,2127,435
1/26/2022,Louisiana,4533372,328,73467,2089,426
1/27/2022,Louisiana,4533372,299,73766,1987,425
1/28/2022,Louisiana,4533372,296,74062,1921,407
1/29/2022,Louisiana,4533372,286,74348,1859,388
1/30/2022,Louisiana,4533372,248,74596,1836,397
1/31/2022,Louisiana,4533372,247,74843,1869,417
2/1/2022,Louisiana,4533372,270,75113,1861,420
2/2/2022,Louisiana,4533372,293,75406,1843,420
2/3/2022,Louisiana,4533372,281,75687,1748,412
2/4/2022,Louisiana,4533372,252,75939,1719,395
2/5/2022,Louisiana,4533372,207,76146,1598,360
2/6/2022,Louisiana,4533372,163,76309,1524,345
2/7/2022,Louisiana,4533372,161,76470,1470,349
2/8/2022,Louisiana,4533372,184,76654,1373,341
2/9/2022,Louisiana,4533372,184,76838,1373,341
7/1/2021,Massachusetts,6794422,9,33637,72,27
7/2/2021,Massachusetts,6794422,8,33645,63,24
7/3/2021,Massachusetts,6794422,8,33653,60,24
7/4/2021,Massachusetts,6794422,12,33665,60,21
7/5/2021,Massachusetts,6794422,6,33671,55,24
7/6/2021,Massachusetts,6794422,15,33686,60,23
7/7/2021,Massachusetts,6794422,14,33700,64,26
7/8/2021,Massachusetts,6794422,13,33713,65,24
7/9/2021,Massachusetts,6794422,23,33736,62,28
7/10/2021,Massachusetts,6794422,17,33753,65,29
7/11/2021,Massachusetts,6794422,18,33771,69,34
7/12/2021,Massachusetts,6794422,7,33778,61,34
7/13/2021,Massachusetts,6794422,16,33794,65,36
7/14/2021,Massachusetts,6794422,16,33810,74,35
7/15/2021,Massachusetts,6794422,12,33822,75,33
7/16/2021,Massachusetts,6794422,16,33838,80,32
7/17/2021,Massachusetts,6794422,15,33853,82,34
7/18/2021,Massachusetts,6794422,12,33865,79,30
7/19/2021,Massachusetts,6794422,9,33874,70,32
7/20/2021,Massachusetts,6794422,17,33891,76,33
7/21/2021,Massachusetts,6794422,22,33913,93,35
7/22/2021,Massachusetts,6794422,22,33935,96,28
7/23/2021,Massachusetts,6794422,26,33961,107,30
7/24/2021,Massachusetts,6794422,17,33978,117,30
7/25/2021,Massachusetts,6794422,24,34002,125,31
7/26/2021,Massachusetts,6794422,32,34034,130,32
7/27/2021,Massachusetts,6794422,37,34071,138,36
7/28/2021,Massachusetts,6794422,36,34107,150,39
7/29/2021,Massachusetts,6794422,34,34141,169,41
7/30/2021,Massachusetts,6794422,46,34187,176,45
7/31/2021,Massachusetts,6794422,36,34223,184,45
8/1/2021,Massachusetts,6794422,37,34260,174,49
8/2/2021,Massachusetts,6794422,37,34297,188,52
8/3/2021,Massachusetts,6794422,48,34345,200,59
8/4/2021,Massachusetts,6794422,45,34390,218,56
8/5/2021,Massachusetts,6794422,39,34429,220,62
8/6/2021,Massachusetts,6794422,50,34479,222,65
8/7/2021,Massachusetts,6794422,49,34528,239,67
8/8/2021,Massachusetts,6794422,51,34579,247,75
8/9/2021,Massachusetts,6794422,48,34627,261,74
8/10/2021,Massachusetts,6794422,55,34682,266,81
8/11/2021,Massachusetts,6794422,69,34751,304,80
8/12/2021,Massachusetts,6794422,61,34812,304,75
8/13/2021,Massachusetts,6794422,60,34872,310,76
8/14/2021,Massachusetts,6794422,47,34919,332,77
8/15/2021,Massachusetts,6794422,60,34979,347,80
8/16/2021,Massachusetts,6794422,54,35033,347,84
8/17/2021,Massachusetts,6794422,57,35090,349,87
8/18/2021,Massachusetts,6794422,76,35166,353,92
8/19/2021,Massachusetts,6794422,79,35245,368,105
8/20/2021,Massachusetts,6794422,94,35339,376,116
8/21/2021,Massachusetts,6794422,83,35422,401,125
8/22/2021,Massachusetts,6794422,64,35486,404,136
8/23/2021,Massachusetts,6794422,69,35555,448,138
8/24/2021,Massachusetts,6794422,76,35631,454,142
8/25/2021,Massachusetts,6794422,67,35698,440,138
8/26/2021,Massachusetts,6794422,79,35777,452,145
8/27/2021,Massachusetts,6794422,81,35858,440,153
8/28/2021,Massachusetts,6794422,81,35939,457,152
8/29/2021,Massachusetts,6794422,71,36010,465,152
8/30/2021,Massachusetts,6794422,68,36078,446,159
8/31/2021,Massachusetts,6794422,87,36165,467,164
9/1/2021,Massachusetts,6794422,73,36238,454,155
9/2/2021,Massachusetts,6794422,93,36331,465,159
9/3/2021,Massachusetts,6794422,58,36389,461,156
9/4/2021,Massachusetts,6794422,66,36455,414,149
9/5/2021,Massachusetts,6794422,73,36528,442,154
9/6/2021,Massachusetts,6794422,80,36608,453,162
9/7/2021,Massachusetts,6794422,74,36682,472,165
9/8/2021,Massachusetts,6794422,88,36770,473,164
9/9/2021,Massachusetts,6794422,91,36861,475,165
9/10/2021,Massachusetts,6794422,97,36958,488,161
9/11/2021,Massachusetts,6794422,98,37056,496,159
9/12/2021,Massachusetts,6794422,81,37137,525,167
9/13/2021,Massachusetts,6794422,88,37225,553,165
9/14/2021,Massachusetts,6794422,66,37291,546,170
9/15/2021,Massachusetts,6794422,80,37371,549,171
9/16/2021,Massachusetts,6794422,97,37468,581,174
9/17/2021,Massachusetts,6794422,78,37546,564,168
9/18/2021,Massachusetts,6794422,70,37616,539,167
9/19/2021,Massachusetts,6794422,55,37671,522,167
9/20/2021,Massachusetts,6794422,61,37732,482,170
9/21/2021,Massachusetts,6794422,72,37804,475,167
9/22/2021,Massachusetts,6794422,73,37877,466,163
9/23/2021,Massachusetts,6794422,73,37950,481,161
9/24/2021,Massachusetts,6794422,64,38014,469,160
9/25/2021,Massachusetts,6794422,81,38095,457,157
9/26/2021,Massachusetts,6794422,69,38164,471,153
9/27/2021,Massachusetts,6794422,64,38228,484,164
9/28/2021,Massachusetts,6794422,79,38307,481,162
9/29/2021,Massachusetts,6794422,80,38387,460,164
9/30/2021,Massachusetts,6794422,67,38454,456,157
10/1/2021,Massachusetts,6794422,75,38529,474,154
10/2/2021,Massachusetts,6794422,59,38588,446,160
10/3/2021,Massachusetts,6794422,51,38639,429,163
10/4/2021,Massachusetts,6794422,60,38699,430,164
10/5/2021,Massachusetts,6794422,77,38776,444,154
10/6/2021,Massachusetts,6794422,73,38849,426,149
10/7/2021,Massachusetts,6794422,70,38919,425,146
10/8/2021,Massachusetts,6794422,47,38966,405,136
10/9/2021,Massachusetts,6794422,64,39030,402,139
10/10/2021,Massachusetts,6794422,57,39087,425,139
10/11/2021,Massachusetts,6794422,49,39136,406,142
10/12/2021,Massachusetts,6794422,73,39209,415,150
10/13/2021,Massachusetts,6794422,71,39280,440,140
10/14/2021,Massachusetts,6794422,61,39341,419,139
10/15/2021,Massachusetts,6794422,58,39399,391,138
10/16/2021,Massachusetts,6794422,66,39465,421,141
10/17/2021,Massachusetts,6794422,63,39528,452,137
10/18/2021,Massachusetts,6794422,53,39581,445,150
10/19/2021,Massachusetts,6794422,62,39643,430,145
10/20/2021,Massachusetts,6794422,61,39704,404,142
10/21/2021,Massachusetts,6794422,53,39757,393,143
10/22/2021,Massachusetts,6794422,69,39826,397,145
10/23/2021,Massachusetts,6794422,61,39887,400,133
10/24/2021,Massachusetts,6794422,42,39929,402,132
10/25/2021,Massachusetts,6794422,59,39988,416,136
10/26/2021,Massachusetts,6794422,48,40036,403,133
10/27/2021,Massachusetts,6794422,70,40106,396,139
10/28/2021,Massachusetts,6794422,74,40180,400,135
10/29/2021,Massachusetts,6794422,53,40233,385,134
10/30/2021,Massachusetts,6794422,58,40291,389,133
10/31/2021,Massachusetts,6794422,52,40343,404,136
11/1/2021,Massachusetts,6794422,47,40390,399,129
11/2/2021,Massachusetts,6794422,61,40451,389,140
11/3/2021,Massachusetts,6794422,66,40517,365,145
11/4/2021,Massachusetts,6794422,48,40565,364,144
11/5/2021,Massachusetts,6794422,74,40639,386,143
11/6/2021,Massachusetts,6794422,65,40704,376,135
11/7/2021,Massachusetts,6794422,55,40759,384,134
11/8/2021,Massachusetts,6794422,45,40804,380,139
11/9/2021,Massachusetts,6794422,77,40881,396,137
11/10/2021,Massachusetts,6794422,77,40958,415,132
11/11/2021,Massachusetts,6794422,65,41023,415,129
11/12/2021,Massachusetts,6794422,82,41105,428,134
11/13/2021,Massachusetts,6794422,81,41186,444,129
11/14/2021,Massachusetts,6794422,65,41251,453,128
11/15/2021,Massachusetts,6794422,77,41328,488,125
11/16/2021,Massachusetts,6794422,110,41438,533,124
11/17/2021,Massachusetts,6794422,91,41529,551,131
11/18/2021,Massachusetts,6794422,90,41619,566,129
11/19/2021,Massachusetts,6794422,96,41715,563,142
11/20/2021,Massachusetts,6794422,98,41813,570,142
11/21/2021,Massachusetts,6794422,88,41901,602,144
11/22/2021,Massachusetts,6794422,94,41995,604,155
11/23/2021,Massachusetts,6794422,111,42106,619,164
11/24/2021,Massachusetts,6794422,93,42199,642,158
11/25/2021,Massachusetts,6794422,109,42308,664,154
11/26/2021,Massachusetts,6794422,94,42402,679,160
11/27/2021,Massachusetts,6794422,122,42524,705,168
11/28/2021,Massachusetts,6794422,103,42627,707,178
11/29/2021,Massachusetts,6794422,102,42729,732,189
11/30/2021,Massachusetts,6794422,120,42849,771,201
12/1/2021,Massachusetts,6794422,140,42989,828,204
12/2/2021,Massachusetts,6794422,117,43106,860,191
12/3/2021,Massachusetts,6794422,137,43243,864,209
12/4/2021,Massachusetts,6794422,156,43399,898,216
12/5/2021,Massachusetts,6794422,138,43537,940,222
12/6/2021,Massachusetts,6794422,141,43678,929,239
12/7/2021,Massachusetts,6794422,177,43855,987,252
12/8/2021,Massachusetts,6794422,191,44046,1007,259
12/9/2021,Massachusetts,6794422,174,44220,1005,264
12/10/2021,Massachusetts,6794422,175,44395,1059,271
12/11/2021,Massachusetts,6794422,164,44559,1078,268
12/12/2021,Massachusetts,6794422,179,44738,1102,284
12/13/2021,Massachusetts,6794422,153,44891,1134,302
12/14/2021,Massachusetts,6794422,187,45078,1098,323
12/15/2021,Massachusetts,6794422,176,45254,1176,316
12/16/2021,Massachusetts,6794422,175,45429,1209,314
12/17/2021,Massachusetts,6794422,184,45613,1210,334
12/18/2021,Massachusetts,6794422,194,45807,1194,346
12/19/2021,Massachusetts,6794422,163,45970,1206,341
12/20/2021,Massachusetts,6794422,182,46152,1267,356
12/21/2021,Massachusetts,6794422,216,46368,1281,343
12/22/2021,Massachusetts,6794422,215,46583,1294,351
12/23/2021,Massachusetts,6794422,166,46749,1273,349
12/24/2021,Massachusetts,6794422,184,46933,1272,353
12/25/2021,Massachusetts,6794422,196,47129,1247,349
12/26/2021,Massachusetts,6794422,160,47289,1295,370
12/27/2021,Massachusetts,6794422,216,47505,1349,369
12/28/2021,Massachusetts,6794422,238,47743,1341,380
12/29/2021,Massachusetts,6794422,297,48040,1507,368
12/30/2021,Massachusetts,6794422,331,48371,1640,371
12/31/2021,Massachusetts,6794422,332,48703,1734,374
1/1/2022,Massachusetts,6794422,313,49016,1773,382
1/2/2022,Massachusetts,6794422,319,49335,1911,384
1/3/2022,Massachusetts,6794422,316,49651,1986,423
1/4/2022,Massachusetts,6794422,339,49990,2046,408
1/5/2022,Massachusetts,6794422,387,50377,2310,394
1/6/2022,Massachusetts,6794422,404,50781,2433,397
1/7/2022,Massachusetts,6794422,415,51196,2579,384
1/8/2022,Massachusetts,6794422,374,51570,2712,395
1/9/2022,Massachusetts,6794422,373,51943,2735,402
1/10/2022,Massachusetts,6794422,400,52343,2662,422
1/11/2022,Massachusetts,6794422,464,52807,2772,442
1/12/2022,Massachusetts,6794422,453,53260,2950,458
1/13/2022,Massachusetts,6794422,473,53733,3029,434
1/14/2022,Massachusetts,6794422,495,54228,3102,443
1/15/2022,Massachusetts,6794422,457,54685,2953,441
1/16/2022,Massachusetts,6794422,385,55070,2997,441
1/17/2022,Massachusetts,6794422,331,55401,2863,440
1/18/2022,Massachusetts,6794422,363,55764,2860,449
1/19/2022,Massachusetts,6794422,430,56194,2891,436
1/20/2022,Massachusetts,6794422,375,56569,2857,423
1/21/2022,Massachusetts,6794422,390,56959,2774,412
1/22/2022,Massachusetts,6794422,353,57312,2566,407
1/23/2022,Massachusetts,6794422,300,57612,2539,389
1/24/2022,Massachusetts,6794422,262,57874,2391,384
1/25/2022,Massachusetts,6794422,332,58206,2301,390
1/26/2022,Massachusetts,6794422,345,58551,2270,379
1/27/2022,Massachusetts,6794422,311,58862,2162,349
1/28/2022,Massachusetts,6794422,275,59137,2004,337
1/29/2022,Massachusetts,6794422,245,59382,1830,300
1/30/2022,Massachusetts,6794422,138,59520,1835,313
1/31/2022,Massachusetts,6794422,150,59670,1717,296
2/1/2022,Massachusetts,6794422,198,59868,1558,288
2/2/2022,Massachusetts,6794422,233,60101,1467,263
2/3/2022,Massachusetts,6794422,194,60295,1414,253
2/4/2022,Massachusetts,6794422,199,60494,1319,243
2/5/2022,Massachusetts,6794422,167,60661,1246,222
2/6/2022,Massachusetts,6794422,139,60800,1219,216
2/7/2022,Massachusetts,6794422,112,60912,1145,211
2/8/2022,Massachusetts,6794422,131,61043,1059,206
2/9/2022,Massachusetts,6794422,131,61174,1059,206
7/1/2021,Maryland,6045680,13,39289,111,28
7/2/2021,Maryland,6045680,17,39306,104,32
7/3/2021,Maryland,6045680,15,39321,107,30
7/4/2021,Maryland,6045680,15,39336,108,28
7/5/2021,Maryland,6045680,22,39358,125,29
7/6/2021,Maryland,6045680,22,39380,130,31
7/7/2021,Maryland,6045680,18,39398,111,28
7/8/2021,Maryland,6045680,16,39414,110,25
7/9/2021,Maryland,6045680,23,39437,114,28
7/10/2021,Maryland,6045680,19,39456,116,30
7/11/2021,Maryland,6045680,11,39467,118,34
7/12/2021,Maryland,6045680,17,39484,125,36
7/13/2021,Maryland,6045680,13,39497,133,41
7/14/2021,Maryland,6045680,20,39517,127,38
7/15/2021,Maryland,6045680,17,39534,120,39
7/16/2021,Maryland,6045680,26,39560,127,34
7/17/2021,Maryland,6045680,21,39581,134,33
7/18/2021,Maryland,6045680,16,39597,130,38
7/19/2021,Maryland,6045680,21,39618,143,41
7/20/2021,Maryland,6045680,23,39641,145,40
7/21/2021,Maryland,6045680,24,39665,148,38
7/22/2021,Maryland,6045680,25,39690,163,36
7/23/2021,Maryland,6045680,30,39720,166,41
7/24/2021,Maryland,6045680,30,39750,166,35
7/25/2021,Maryland,6045680,35,39785,173,40
7/26/2021,Maryland,6045680,30,39815,195,52
7/27/2021,Maryland,6045680,34,39849,207,49
7/28/2021,Maryland,6045680,46,39895,218,51
7/29/2021,Maryland,6045680,35,39930,223,51
7/30/2021,Maryland,6045680,47,39977,236,57
7/31/2021,Maryland,6045680,50,40027,256,68
8/1/2021,Maryland,6045680,50,40077,285,78
8/2/2021,Maryland,6045680,30,40107,299,78
8/3/2021,Maryland,6045680,55,40162,320,75
8/4/2021,Maryland,6045680,64,40226,343,79
8/5/2021,Maryland,6045680,49,40275,344,78
8/6/2021,Maryland,6045680,65,40340,349,89
8/7/2021,Maryland,6045680,69,40409,386,92
8/8/2021,Maryland,6045680,72,40481,422,108
8/9/2021,Maryland,6045680,48,40529,421,96
8/10/2021,Maryland,6045680,75,40604,449,107
8/11/2021,Maryland,6045680,83,40687,481,113
8/12/2021,Maryland,6045680,83,40770,485,118
8/13/2021,Maryland,6045680,75,40845,520,125
8/14/2021,Maryland,6045680,88,40933,555,127
8/15/2021,Maryland,6045680,102,41035,582,130
8/16/2021,Maryland,6045680,71,41106,611,143
8/17/2021,Maryland,6045680,86,41192,621,143
8/18/2021,Maryland,6045680,101,41293,650,149
8/19/2021,Maryland,6045680,83,41376,635,153
8/20/2021,Maryland,6045680,88,41464,637,153
8/21/2021,Maryland,6045680,98,41562,649,156
8/22/2021,Maryland,6045680,104,41666,674,148
8/23/2021,Maryland,6045680,87,41753,700,149
8/24/2021,Maryland,6045680,110,41863,700,165
8/25/2021,Maryland,6045680,96,41959,713,164
8/26/2021,Maryland,6045680,119,42078,729,169
8/27/2021,Maryland,6045680,92,42170,710,175
8/28/2021,Maryland,6045680,92,42262,712,163
8/29/2021,Maryland,6045680,102,42364,728,164
8/30/2021,Maryland,6045680,95,42459,734,165
8/31/2021,Maryland,6045680,102,42561,764,173
9/1/2021,Maryland,6045680,115,42676,769,169
9/2/2021,Maryland,6045680,127,42803,803,178
9/3/2021,Maryland,6045680,103,42906,818,194
9/4/2021,Maryland,6045680,107,43013,828,191
9/5/2021,Maryland,6045680,88,43101,807,184
9/6/2021,Maryland,6045680,99,43200,808,201
9/7/2021,Maryland,6045680,110,43310,815,208
9/8/2021,Maryland,6045680,103,43413,820,211
9/9/2021,Maryland,6045680,106,43519,814,203
9/10/2021,Maryland,6045680,103,43622,815,209
9/11/2021,Maryland,6045680,80,43702,796,203
9/12/2021,Maryland,6045680,81,43783,792,194
9/13/2021,Maryland,6045680,85,43868,815,194
9/14/2021,Maryland,6045680,108,43976,809,212
9/15/2021,Maryland,6045680,100,44076,799,200
9/16/2021,Maryland,6045680,115,44191,802,202
9/17/2021,Maryland,6045680,98,44289,825,210
9/18/2021,Maryland,6045680,108,44397,830,207
9/19/2021,Maryland,6045680,101,44498,842,209
9/20/2021,Maryland,6045680,83,44581,845,206
9/21/2021,Maryland,6045680,118,44699,835,196
9/22/2021,Maryland,6045680,91,44790,815,185
9/23/2021,Maryland,6045680,93,44883,784,190
9/24/2021,Maryland,6045680,121,45004,787,192
9/25/2021,Maryland,6045680,102,45106,785,190
9/26/2021,Maryland,6045680,78,45184,773,182
9/27/2021,Maryland,6045680,78,45262,783,193
9/28/2021,Maryland,6045680,97,45359,776,189
9/29/2021,Maryland,6045680,93,45452,793,207
9/30/2021,Maryland,6045680,101,45553,799,209
10/1/2021,Maryland,6045680,109,45662,806,199
10/2/2021,Maryland,6045680,106,45768,790,197
10/3/2021,Maryland,6045680,72,45840,788,200
10/4/2021,Maryland,6045680,88,45928,779,194
10/5/2021,Maryland,6045680,91,46019,792,209
10/6/2021,Maryland,6045680,99,46118,784,201
10/7/2021,Maryland,6045680,112,46230,795,191
10/8/2021,Maryland,6045680,87,46317,776,195
10/9/2021,Maryland,6045680,76,46393,768,191
10/10/2021,Maryland,6045680,79,46472,758,183
10/11/2021,Maryland,6045680,72,46544,746,187
10/12/2021,Maryland,6045680,89,46633,750,179
10/13/2021,Maryland,6045680,88,46721,736,189
10/14/2021,Maryland,6045680,90,46811,732,168
10/15/2021,Maryland,6045680,83,46894,715,167
10/16/2021,Maryland,6045680,76,46970,705,172
10/17/2021,Maryland,6045680,64,47034,694,173
10/18/2021,Maryland,6045680,57,47091,724,183
10/19/2021,Maryland,6045680,73,47164,682,170
10/20/2021,Maryland,6045680,74,47238,651,153
10/21/2021,Maryland,6045680,74,47312,658,151
10/22/2021,Maryland,6045680,76,47388,636,142
10/23/2021,Maryland,6045680,71,47459,616,140
10/24/2021,Maryland,6045680,51,47510,621,141
10/25/2021,Maryland,6045680,56,47566,607,141
10/26/2021,Maryland,6045680,78,47644,595,144
10/27/2021,Maryland,6045680,66,47710,585,145
10/28/2021,Maryland,6045680,86,47796,610,153
10/29/2021,Maryland,6045680,72,47868,599,141
10/30/2021,Maryland,6045680,66,47934,580,140
10/31/2021,Maryland,6045680,56,47990,567,150
11/1/2021,Maryland,6045680,54,48044,566,149
11/2/2021,Maryland,6045680,67,48111,544,141
11/3/2021,Maryland,6045680,62,48173,524,143
11/4/2021,Maryland,6045680,57,48230,514,134
11/5/2021,Maryland,6045680,74,48304,543,128
11/6/2021,Maryland,6045680,63,48367,524,132
11/7/2021,Maryland,6045680,58,48425,520,127
11/8/2021,Maryland,6045680,60,48485,526,127
11/9/2021,Maryland,6045680,62,48547,532,135
11/10/2021,Maryland,6045680,67,48614,510,124
11/11/2021,Maryland,6045680,69,48683,516,126
11/12/2021,Maryland,6045680,69,48752,500,130
11/13/2021,Maryland,6045680,75,48827,499,123
11/14/2021,Maryland,6045680,59,48886,503,127
11/15/2021,Maryland,6045680,50,48936,501,122
11/16/2021,Maryland,6045680,82,49018,532,112
11/17/2021,Maryland,6045680,85,49103,552,124
11/18/2021,Maryland,6045680,96,49199,556,125
11/19/2021,Maryland,6045680,77,49276,552,127
11/20/2021,Maryland,6045680,69,49345,565,125
11/21/2021,Maryland,6045680,58,49403,569,131
11/22/2021,Maryland,6045680,75,49478,580,142
11/23/2021,Maryland,6045680,98,49576,603,154
11/24/2021,Maryland,6045680,80,49656,597,162
11/25/2021,Maryland,6045680,85,49741,591,154
11/26/2021,Maryland,6045680,72,49813,616,160
11/27/2021,Maryland,6045680,92,49905,644,159
11/28/2021,Maryland,6045680,82,49987,643,160
11/29/2021,Maryland,6045680,80,50067,658,159
11/30/2021,Maryland,6045680,104,50171,709,161
12/1/2021,Maryland,6045680,108,50279,750,176
12/2/2021,Maryland,6045680,121,50400,763,179
12/3/2021,Maryland,6045680,112,50512,777,180
12/4/2021,Maryland,6045680,118,50630,830,169
12/5/2021,Maryland,6045680,123,50753,819,163
12/6/2021,Maryland,6045680,116,50869,878,187
12/7/2021,Maryland,6045680,134,51003,935,193
12/8/2021,Maryland,6045680,144,51147,978,215
12/9/2021,Maryland,6045680,160,51307,1040,221
12/10/2021,Maryland,6045680,138,51445,1042,222
12/11/2021,Maryland,6045680,128,51573,1055,230
12/12/2021,Maryland,6045680,140,51713,1115,245
12/13/2021,Maryland,6045680,146,51859,1150,258
12/14/2021,Maryland,6045680,160,52019,1141,250
12/15/2021,Maryland,6045680,166,52185,1170,256
12/16/2021,Maryland,6045680,166,52351,1231,271
12/17/2021,Maryland,6045680,175,52526,1264,265
12/18/2021,Maryland,6045680,167,52693,1299,270
12/19/2021,Maryland,6045680,234,52927,1353,300
12/20/2021,Maryland,6045680,153,53080,1357,291
12/21/2021,Maryland,6045680,225,53305,1448,297
12/22/2021,Maryland,6045680,225,53530,1495,303
12/23/2021,Maryland,6045680,229,53759,1510,309
12/24/2021,Maryland,6045680,243,54002,1530,302
12/25/2021,Maryland,6045680,251,54253,1601,312
12/26/2021,Maryland,6045680,268,54521,1678,308
12/27/2021,Maryland,6045680,282,54803,1829,331
12/28/2021,Maryland,6045680,356,55159,1965,347
12/29/2021,Maryland,6045680,414,55573,2304,393
12/30/2021,Maryland,6045680,445,56018,2354,382
12/31/2021,Maryland,6045680,435,56453,2550,412
1/1/2022,Maryland,6045680,421,56874,2613,430
1/2/2022,Maryland,6045680,436,57310,2802,454
1/3/2022,Maryland,6045680,481,57791,2914,474
1/4/2022,Maryland,6045680,442,58233,3050,497
1/5/2022,Maryland,6045680,474,58707,3230,499
1/6/2022,Maryland,6045680,538,59245,3344,503
1/7/2022,Maryland,6045680,542,59787,3412,519
1/8/2022,Maryland,6045680,515,60302,3443,520
1/9/2022,Maryland,6045680,376,60678,3463,532
1/10/2022,Maryland,6045680,453,61131,3500,544
1/11/2022,Maryland,6045680,473,61604,3533,563
1/12/2022,Maryland,6045680,408,62012,3539,569
1/13/2022,Maryland,6045680,371,62383,3457,560
1/14/2022,Maryland,6045680,415,62798,3371,556
1/15/2022,Maryland,6045680,399,63197,3261,546
1/16/2022,Maryland,6045680,289,63486,3215,536
1/17/2022,Maryland,6045680,261,63747,3089,545
1/18/2022,Maryland,6045680,322,64069,3086,534
1/19/2022,Maryland,6045680,275,64344,2999,513
1/20/2022,Maryland,6045680,311,64655,2809,488
1/21/2022,Maryland,6045680,291,64946,2629,478
1/22/2022,Maryland,6045680,281,65227,2517,457
1/23/2022,Maryland,6045680,218,65445,2441,441
1/24/2022,Maryland,6045680,213,65658,2405,434
1/25/2022,Maryland,6045680,244,65902,2255,413
1/26/2022,Maryland,6045680,231,66133,2114,371
1/27/2022,Maryland,6045680,187,66320,2011,359
1/28/2022,Maryland,6045680,180,66500,1852,339
1/29/2022,Maryland,6045680,195,66695,1756,342
1/30/2022,Maryland,6045680,134,66829,1726,349
1/31/2022,Maryland,6045680,137,66966,1686,314
2/1/2022,Maryland,6045680,164,67130,1562,339
2/2/2022,Maryland,6045680,155,67285,1499,310
2/3/2022,Maryland,6045680,154,67439,1374,283
2/4/2022,Maryland,6045680,138,67577,1302,262
2/5/2022,Maryland,6045680,131,67708,1217,241
2/6/2022,Maryland,6045680,103,67811,1177,211
2/7/2022,Maryland,6045680,97,67908,1137,206
2/8/2022,Maryland,6045680,121,68029,1095,197
2/9/2022,Maryland,6045680,121,68150,1095,197
7/1/2021,Maine,1328361,3,3002,32,14
7/2/2021,Maine,1328361,5,3007,32,15
7/3/2021,Maine,1328361,4,3011,31,14
7/4/2021,Maine,1328361,3,3014,28,14
7/5/2021,Maine,1328361,2,3016,27,15
7/6/2021,Maine,1328361,4,3020,27,15
7/7/2021,Maine,1328361,5,3025,34,15
7/8/2021,Maine,1328361,5,3030,34,14
7/9/2021,Maine,1328361,4,3034,39,18
7/10/2021,Maine,1328361,6,3040,36,19
7/11/2021,Maine,1328361,4,3044,32,15
7/12/2021,Maine,1328361,5,3049,37,17
7/13/2021,Maine,1328361,7,3056,35,18
7/14/2021,Maine,1328361,5,3061,32,14
7/15/2021,Maine,1328361,5,3066,32,14
7/16/2021,Maine,1328361,4,3070,32,15
7/17/2021,Maine,1328361,2,3072,26,10
7/18/2021,Maine,1328361,4,3076,27,10
7/19/2021,Maine,1328361,6,3082,31,13
7/20/2021,Maine,1328361,8,3090,32,13
7/21/2021,Maine,1328361,3,3093,27,13
7/22/2021,Maine,1328361,5,3098,31,16
7/23/2021,Maine,1328361,11,3109,40,17
7/24/2021,Maine,1328361,9,3118,43,17
7/25/2021,Maine,1328361,11,3129,48,20
7/26/2021,Maine,1328361,2,3131,45,17
7/27/2021,Maine,1328361,12,3143,54,15
7/28/2021,Maine,1328361,11,3154,53,17
7/29/2021,Maine,1328361,10,3164,51,18
7/30/2021,Maine,1328361,6,3170,49,18
7/31/2021,Maine,1328361,8,3178,47,19
8/1/2021,Maine,1328361,6,3184,48,19
8/2/2021,Maine,1328361,8,3192,51,22
8/3/2021,Maine,1328361,9,3201,52,21
8/4/2021,Maine,1328361,6,3207,53,21
8/5/2021,Maine,1328361,11,3218,54,23
8/6/2021,Maine,1328361,6,3224,52,23
8/7/2021,Maine,1328361,10,3234,55,22
8/8/2021,Maine,1328361,7,3241,55,21
8/9/2021,Maine,1328361,13,3254,62,25
8/10/2021,Maine,1328361,11,3265,61,27
8/11/2021,Maine,1328361,7,3272,62,30
8/12/2021,Maine,1328361,20,3292,73,35
8/13/2021,Maine,1328361,9,3301,69,35
8/14/2021,Maine,1328361,10,3311,70,35
8/15/2021,Maine,1328361,17,3328,83,40
8/16/2021,Maine,1328361,12,3340,89,41
8/17/2021,Maine,1328361,8,3348,90,42
8/18/2021,Maine,1328361,15,3363,97,45
8/19/2021,Maine,1328361,20,3383,96,40
8/20/2021,Maine,1328361,11,3394,94,43
8/21/2021,Maine,1328361,17,3411,101,44
8/22/2021,Maine,1328361,21,3432,115,54
8/23/2021,Maine,1328361,20,3452,124,58
8/24/2021,Maine,1328361,19,3471,125,53
8/25/2021,Maine,1328361,20,3491,134,61
8/26/2021,Maine,1328361,19,3510,141,62
8/27/2021,Maine,1328361,18,3528,138,64
8/28/2021,Maine,1328361,16,3544,127,58
8/29/2021,Maine,1328361,18,3562,132,60
8/30/2021,Maine,1328361,23,3585,137,60
8/31/2021,Maine,1328361,26,3611,150,63
9/1/2021,Maine,1328361,29,3640,169,67
9/2/2021,Maine,1328361,17,3657,168,60
9/3/2021,Maine,1328361,15,3672,163,56
9/4/2021,Maine,1328361,18,3690,164,60
9/5/2021,Maine,1328361,13,3703,169,63
9/6/2021,Maine,1328361,22,3725,179,65
9/7/2021,Maine,1328361,18,3743,183,66
9/8/2021,Maine,1328361,16,3759,186,67
9/9/2021,Maine,1328361,22,3781,190,71
9/10/2021,Maine,1328361,15,3796,186,68
9/11/2021,Maine,1328361,12,3808,173,67
9/12/2021,Maine,1328361,27,3835,183,68
9/13/2021,Maine,1328361,21,3856,187,67
9/14/2021,Maine,1328361,19,3875,188,70
9/15/2021,Maine,1328361,17,3892,184,67
9/16/2021,Maine,1328361,30,3922,190,72
9/17/2021,Maine,1328361,31,3953,209,80
9/18/2021,Maine,1328361,35,3988,217,87
9/19/2021,Maine,1328361,19,4007,223,87
9/20/2021,Maine,1328361,29,4036,230,85
9/21/2021,Maine,1328361,28,4064,231,86
9/22/2021,Maine,1328361,35,4099,229,87
9/23/2021,Maine,1328361,22,4121,226,78
9/24/2021,Maine,1328361,18,4139,226,80
9/25/2021,Maine,1328361,25,4164,234,81
9/26/2021,Maine,1328361,17,4181,228,79
9/27/2021,Maine,1328361,30,4211,231,71
9/28/2021,Maine,1328361,24,4235,220,68
9/29/2021,Maine,1328361,38,4273,234,74
9/30/2021,Maine,1328361,24,4297,227,67
10/1/2021,Maine,1328361,19,4316,215,63
10/2/2021,Maine,1328361,16,4332,197,59
10/3/2021,Maine,1328361,12,4344,190,61
10/4/2021,Maine,1328361,15,4359,192,59
10/5/2021,Maine,1328361,15,4374,179,52
10/6/2021,Maine,1328361,16,4390,166,47
10/7/2021,Maine,1328361,18,4408,162,49
10/8/2021,Maine,1328361,17,4425,157,48
10/9/2021,Maine,1328361,16,4441,156,50
10/10/2021,Maine,1328361,16,4457,162,56
10/11/2021,Maine,1328361,20,4477,177,56
10/12/2021,Maine,1328361,31,4508,184,64
10/13/2021,Maine,1328361,20,4528,182,65
10/14/2021,Maine,1328361,21,4549,174,61
10/15/2021,Maine,1328361,25,4574,170,62
10/16/2021,Maine,1328361,22,4596,181,66
10/17/2021,Maine,1328361,14,4610,192,65
10/18/2021,Maine,1328361,26,4636,209,68
10/19/2021,Maine,1328361,22,4658,209,72
10/20/2021,Maine,1328361,22,4680,206,73
10/21/2021,Maine,1328361,26,4706,208,80
10/22/2021,Maine,1328361,30,4736,204,71
10/23/2021,Maine,1328361,27,4763,214,80
10/24/2021,Maine,1328361,23,4786,219,82
10/25/2021,Maine,1328361,19,4805,232,83
10/26/2021,Maine,1328361,19,4824,225,81
10/27/2021,Maine,1328361,26,4850,215,77
10/28/2021,Maine,1328361,19,4869,196,73
10/29/2021,Maine,1328361,26,4895,196,76
10/30/2021,Maine,1328361,22,4917,204,77
10/31/2021,Maine,1328361,18,4935,204,84
11/1/2021,Maine,1328361,24,4959,222,81
11/2/2021,Maine,1328361,29,4988,221,81
11/3/2021,Maine,1328361,30,5018,231,78
11/4/2021,Maine,1328361,31,5049,232,80
11/5/2021,Maine,1328361,15,5064,227,76
11/6/2021,Maine,1328361,22,5086,218,74
11/7/2021,Maine,1328361,22,5108,221,77
11/8/2021,Maine,1328361,23,5131,221,74
11/9/2021,Maine,1328361,23,5154,225,71
11/10/2021,Maine,1328361,39,5193,239,69
11/11/2021,Maine,1328361,27,5220,250,72
11/12/2021,Maine,1328361,31,5251,260,71
11/13/2021,Maine,1328361,22,5273,256,71
11/14/2021,Maine,1328361,35,5308,271,73
11/15/2021,Maine,1328361,31,5339,290,76
11/16/2021,Maine,1328361,38,5377,294,78
11/17/2021,Maine,1328361,27,5404,295,79
11/18/2021,Maine,1328361,26,5430,285,79
11/19/2021,Maine,1328361,36,5466,287,91
11/20/2021,Maine,1328361,36,5502,288,79
11/21/2021,Maine,1328361,32,5534,302,90
11/22/2021,Maine,1328361,27,5561,311,98
11/23/2021,Maine,1328361,46,5607,326,106
11/24/2021,Maine,1328361,46,5653,332,112
11/25/2021,Maine,1328361,35,5688,332,110
11/26/2021,Maine,1328361,40,5728,335,111
11/27/2021,Maine,1328361,41,5769,338,108
11/28/2021,Maine,1328361,30,5799,338,102
11/29/2021,Maine,1328361,29,5828,334,101
11/30/2021,Maine,1328361,40,5868,343,107
12/1/2021,Maine,1328361,42,5910,352,108
12/2/2021,Maine,1328361,29,5939,339,109
12/3/2021,Maine,1328361,38,5977,332,107
12/4/2021,Maine,1328361,39,6016,336,111
12/5/2021,Maine,1328361,34,6050,348,116
12/6/2021,Maine,1328361,47,6097,372,123
12/7/2021,Maine,1328361,39,6136,375,120
12/8/2021,Maine,1328361,51,6187,387,128
12/9/2021,Maine,1328361,51,6238,379,130
12/10/2021,Maine,1328361,56,6294,394,132
12/11/2021,Maine,1328361,46,6340,392,127
12/12/2021,Maine,1328361,36,6376,396,122
12/13/2021,Maine,1328361,32,6408,403,122
12/14/2021,Maine,1328361,60,6468,400,132
12/15/2021,Maine,1328361,41,6509,398,125
12/16/2021,Maine,1328361,41,6550,395,125
12/17/2021,Maine,1328361,41,6591,395,133
12/18/2021,Maine,1328361,42,6633,393,135
12/19/2021,Maine,1328361,41,6674,399,145
12/20/2021,Maine,1328361,28,6702,395,134
12/21/2021,Maine,1328361,48,6750,403,140
12/22/2021,Maine,1328361,32,6782,370,134
12/23/2021,Maine,1328361,31,6813,365,125
12/24/2021,Maine,1328361,30,6843,348,118
12/25/2021,Maine,1328361,17,6860,338,113
12/26/2021,Maine,1328361,34,6894,341,116
12/27/2021,Maine,1328361,19,6913,347,123
12/28/2021,Maine,1328361,30,6943,336,114
12/29/2021,Maine,1328361,39,6982,342,115
12/30/2021,Maine,1328361,32,7014,333,119
12/31/2021,Maine,1328361,33,7047,339,117
1/1/2022,Maine,1328361,44,7091,344,114
1/2/2022,Maine,1328361,27,7118,365,121
1/3/2022,Maine,1328361,34,7152,377,121
1/4/2022,Maine,1328361,35,7187,391,129
1/5/2022,Maine,1328361,31,7218,395,135
1/6/2022,Maine,1328361,42,7260,398,126
1/7/2022,Maine,1328361,37,7297,412,126
1/8/2022,Maine,1328361,43,7340,416,119
1/9/2022,Maine,1328361,29,7369,406,115
1/10/2022,Maine,1328361,27,7396,425,116
1/11/2022,Maine,1328361,31,7427,422,115
1/12/2022,Maine,1328361,42,7469,442,117
1/13/2022,Maine,1328361,47,7516,452,114
1/14/2022,Maine,1328361,38,7554,445,113
1/15/2022,Maine,1328361,33,7587,425,109
1/16/2022,Maine,1328361,31,7618,418,112
1/17/2022,Maine,1328361,27,7645,405,108
1/18/2022,Maine,1328361,41,7686,425,109
1/19/2022,Maine,1328361,42,7728,444,107
1/20/2022,Maine,1328361,41,7769,434,106
1/21/2022,Maine,1328361,47,7816,439,109
1/22/2022,Maine,1328361,38,7854,455,108
1/23/2022,Maine,1328361,25,7879,450,107
1/24/2022,Maine,1328361,33,7912,458,103
1/25/2022,Maine,1328361,39,7951,455,100
1/26/2022,Maine,1328361,41,7992,456,97
1/27/2022,Maine,1328361,34,8026,437,91
1/28/2022,Maine,1328361,34,8060,393,89
1/29/2022,Maine,1328361,36,8096,386,91
1/30/2022,Maine,1328361,33,8129,409,96
1/31/2022,Maine,1328361,33,8162,390,97
2/1/2022,Maine,1328361,46,8208,394,93
2/2/2022,Maine,1328361,43,8251,398,93
2/3/2022,Maine,1328361,48,8299,395,92
2/4/2022,Maine,1328361,34,8333,388,91
2/5/2022,Maine,1328361,30,8363,379,88
2/6/2022,Maine,1328361,35,8398,377,90
2/7/2022,Maine,1328361,16,8414,361,83
2/8/2022,Maine,1328361,30,8444,350,80
2/9/2022,Maine,1328361,28,8472,349,79
7/1/2021,Michigan,9922576,24,74525,257,72
7/2/2021,Michigan,9922576,32,74557,248,66
7/3/2021,Michigan,9922576,30,74587,238,58
7/4/2021,Michigan,9922576,27,74614,238,63
7/5/2021,Michigan,9922576,29,74643,238,62
7/6/2021,Michigan,9922576,27,74670,226,54
7/7/2021,Michigan,9922576,41,74711,228,57
7/8/2021,Michigan,9922576,19,74730,217,59
7/9/2021,Michigan,9922576,37,74767,218,56
7/10/2021,Michigan,9922576,31,74798,206,52
7/11/2021,Michigan,9922576,26,74824,204,52
7/12/2021,Michigan,9922576,26,74850,212,55
7/13/2021,Michigan,9922576,42,74892,224,56
7/14/2021,Michigan,9922576,31,74923,219,54
7/15/2021,Michigan,9922576,38,74961,214,57
7/16/2021,Michigan,9922576,41,75002,240,61
7/17/2021,Michigan,9922576,31,75033,228,58
7/18/2021,Michigan,9922576,50,75083,247,58
7/19/2021,Michigan,9922576,29,75112,248,55
7/20/2021,Michigan,9922576,39,75151,252,60
7/21/2021,Michigan,9922576,47,75198,257,67
7/22/2021,Michigan,9922576,39,75237,260,60
7/23/2021,Michigan,9922576,39,75276,265,63
7/24/2021,Michigan,9922576,43,75319,280,70
7/25/2021,Michigan,9922576,34,75353,277,79
7/26/2021,Michigan,9922576,49,75402,309,85
7/27/2021,Michigan,9922576,49,75451,315,82
7/28/2021,Michigan,9922576,40,75491,293,71
7/29/2021,Michigan,9922576,45,75536,309,80
7/30/2021,Michigan,9922576,50,75586,310,81
7/31/2021,Michigan,9922576,45,75631,320,85
8/1/2021,Michigan,9922576,57,75688,325,91
8/2/2021,Michigan,9922576,65,75753,360,90
8/3/2021,Michigan,9922576,96,75849,443,108
8/4/2021,Michigan,9922576,83,75932,473,124
8/5/2021,Michigan,9922576,83,76015,495,130
8/6/2021,Michigan,9922576,95,76110,531,153
8/7/2021,Michigan,9922576,92,76202,584,155
8/8/2021,Michigan,9922576,79,76281,614,153
8/9/2021,Michigan,9922576,91,76372,671,172
8/10/2021,Michigan,9922576,119,76491,698,175
8/11/2021,Michigan,9922576,133,76624,758,182
8/12/2021,Michigan,9922576,123,76747,777,191
8/13/2021,Michigan,9922576,127,76874,813,194
8/14/2021,Michigan,9922576,102,76976,781,201
8/15/2021,Michigan,9922576,108,77084,793,206
8/16/2021,Michigan,9922576,107,77191,829,204
8/17/2021,Michigan,9922576,129,77320,819,218
8/18/2021,Michigan,9922576,130,77450,856,221
8/19/2021,Michigan,9922576,136,77586,888,219
8/20/2021,Michigan,9922576,152,77738,917,225
8/21/2021,Michigan,9922576,129,77867,927,232
8/22/2021,Michigan,9922576,145,78012,976,246
8/23/2021,Michigan,9922576,128,78140,1059,249
8/24/2021,Michigan,9922576,149,78289,1093,276
8/25/2021,Michigan,9922576,151,78440,1122,274
8/26/2021,Michigan,9922576,173,78613,1130,288
8/27/2021,Michigan,9922576,155,78768,1138,297
8/28/2021,Michigan,9922576,156,78924,1128,312
8/29/2021,Michigan,9922576,93,79017,1124,318
8/30/2021,Michigan,9922576,142,79159,1158,315
8/31/2021,Michigan,9922576,164,79323,1128,318
9/1/2021,Michigan,9922576,168,79491,1168,338
9/2/2021,Michigan,9922576,148,79639,1157,335
9/3/2021,Michigan,9922576,153,79792,1174,329
9/4/2021,Michigan,9922576,160,79952,1145,326
9/5/2021,Michigan,9922576,137,80089,1150,336
9/6/2021,Michigan,9922576,176,80265,1216,360
9/7/2021,Michigan,9922576,178,80443,1291,387
9/8/2021,Michigan,9922576,189,80632,1317,380
9/9/2021,Michigan,9922576,203,80835,1360,389
9/10/2021,Michigan,9922576,164,80999,1376,394
9/11/2021,Michigan,9922576,166,81165,1368,403
9/12/2021,Michigan,9922576,176,81341,1389,399
9/13/2021,Michigan,9922576,174,81515,1423,403
9/14/2021,Michigan,9922576,180,81695,1445,406
9/15/2021,Michigan,9922576,215,81910,1461,407
9/16/2021,Michigan,9922576,185,82095,1390,412
9/17/2021,Michigan,9922576,186,82281,1385,389
9/18/2021,Michigan,9922576,204,82485,1409,388
9/19/2021,Michigan,9922576,183,82668,1401,385
9/20/2021,Michigan,9922576,172,82840,1432,400
9/21/2021,Michigan,9922576,190,83030,1438,401
9/22/2021,Michigan,9922576,199,83229,1467,418
9/23/2021,Michigan,9922576,206,83435,1483,416
9/24/2021,Michigan,9922576,200,83635,1501,426
9/25/2021,Michigan,9922576,219,83854,1504,421
9/26/2021,Michigan,9922576,205,84059,1532,427
9/27/2021,Michigan,9922576,196,84255,1566,424
9/28/2021,Michigan,9922576,226,84481,1549,425
9/29/2021,Michigan,9922576,217,84698,1600,438
9/30/2021,Michigan,9922576,216,84914,1602,435
10/1/2021,Michigan,9922576,236,85150,1621,437
10/2/2021,Michigan,9922576,200,85350,1605,447
10/3/2021,Michigan,9922576,223,85573,1643,454
10/4/2021,Michigan,9922576,217,85790,1717,480
10/5/2021,Michigan,9922576,268,86058,1757,486
10/6/2021,Michigan,9922576,279,86337,1816,492
10/7/2021,Michigan,9922576,276,86613,1882,495
10/8/2021,Michigan,9922576,261,86874,1877,479
10/9/2021,Michigan,9922576,271,87145,1863,530
10/10/2021,Michigan,9922576,262,87407,1946,553
10/11/2021,Michigan,9922576,235,87642,2023,578
10/12/2021,Michigan,9922576,299,87941,2072,596
10/13/2021,Michigan,9922576,297,88238,2115,574
10/14/2021,Michigan,9922576,254,88492,2103,564
10/15/2021,Michigan,9922576,262,88754,2068,574
10/16/2021,Michigan,9922576,255,89009,2052,571
10/17/2021,Michigan,9922576,236,89245,2060,572
10/18/2021,Michigan,9922576,230,89475,2117,593
10/19/2021,Michigan,9922576,284,89759,2158,589
10/20/2021,Michigan,9922576,245,90004,2120,578
10/21/2021,Michigan,9922576,277,90281,2099,597
10/22/2021,Michigan,9922576,262,90543,2086,582
10/23/2021,Michigan,9922576,252,90795,2044,589
10/24/2021,Michigan,9922576,245,91040,2091,595
10/25/2021,Michigan,9922576,250,91290,2122,616
10/26/2021,Michigan,9922576,263,91553,2124,643
10/27/2021,Michigan,9922576,266,91819,2102,624
10/28/2021,Michigan,9922576,263,92082,2080,604
10/29/2021,Michigan,9922576,317,92399,2125,592
10/30/2021,Michigan,9922576,281,92680,2108,544
10/31/2021,Michigan,9922576,242,92922,2125,560
11/1/2021,Michigan,9922576,247,93169,2148,572
11/2/2021,Michigan,9922576,301,93470,2203,582
11/3/2021,Michigan,9922576,293,93763,2199,580
11/4/2021,Michigan,9922576,298,94061,2216,574
11/5/2021,Michigan,9922576,341,94402,2285,571
11/6/2021,Michigan,9922576,314,94716,2295,569
11/7/2021,Michigan,9922576,303,95019,2428,584
11/8/2021,Michigan,9922576,371,95390,2597,587
11/9/2021,Michigan,9922576,382,95772,2623,618
11/10/2021,Michigan,9922576,360,96132,2638,633
11/11/2021,Michigan,9922576,385,96517,2708,645
11/12/2021,Michigan,9922576,432,96949,2799,655
11/13/2021,Michigan,9922576,441,97390,2901,679
11/14/2021,Michigan,9922576,351,97741,2955,677
11/15/2021,Michigan,9922576,405,98146,3087,690
11/16/2021,Michigan,9922576,469,98615,3181,692
11/17/2021,Michigan,9922576,483,99098,3265,694
11/18/2021,Michigan,9922576,560,99658,3420,741
11/19/2021,Michigan,9922576,470,100128,3499,741
11/20/2021,Michigan,9922576,454,100582,3583,776
11/21/2021,Michigan,9922576,466,101048,3633,802
11/22/2021,Michigan,9922576,480,101528,3760,845
11/23/2021,Michigan,9922576,528,102056,3905,821
11/24/2021,Michigan,9922576,546,102602,3951,833
11/25/2021,Michigan,9922576,502,103104,3965,871
11/26/2021,Michigan,9922576,429,103533,4065,884
11/27/2021,Michigan,9922576,469,104002,4039,893
11/28/2021,Michigan,9922576,456,104458,4137,936
11/29/2021,Michigan,9922576,493,104951,4247,925
11/30/2021,Michigan,9922576,561,105512,4351,929
12/1/2021,Michigan,9922576,576,106088,4347,938
12/2/2021,Michigan,9922576,519,106607,4290,957
12/3/2021,Michigan,9922576,592,107199,4392,991
12/4/2021,Michigan,9922576,496,107695,4306,983
12/5/2021,Michigan,9922576,453,108148,4329,1004
12/6/2021,Michigan,9922576,480,108628,4428,1013
12/7/2021,Michigan,9922576,572,109200,4527,1003
12/8/2021,Michigan,9922576,533,109733,4496,1001
12/9/2021,Michigan,9922576,578,110311,4557,979
12/10/2021,Michigan,9922576,553,110864,4576,1008
12/11/2021,Michigan,9922576,518,111382,4536,1016
12/12/2021,Michigan,9922576,449,111831,4562,1027
12/13/2021,Michigan,9922576,413,112244,4575,1036
12/14/2021,Michigan,9922576,499,112743,4502,1020
12/15/2021,Michigan,9922576,451,113194,4408,1002
12/16/2021,Michigan,9922576,458,113652,4304,1021
12/17/2021,Michigan,9922576,436,114088,4231,991
12/18/2021,Michigan,9922576,370,114458,3988,951
12/19/2021,Michigan,9922576,384,114842,3963,959
12/20/2021,Michigan,9922576,342,115184,3966,969
12/21/2021,Michigan,9922576,438,115622,3760,949
12/22/2021,Michigan,9922576,424,116046,3780,925
12/23/2021,Michigan,9922576,409,116455,3601,882
12/24/2021,Michigan,9922576,430,116885,3546,886
12/25/2021,Michigan,9922576,386,117271,3478,884
12/26/2021,Michigan,9922576,380,117651,3618,876
12/27/2021,Michigan,9922576,380,118031,3691,853
12/28/2021,Michigan,9922576,445,118476,3713,852
12/29/2021,Michigan,9922576,492,118968,3735,812
12/30/2021,Michigan,9922576,500,119468,3812,830
12/31/2021,Michigan,9922576,561,120029,3850,807
1/1/2022,Michigan,9922576,517,120546,3922,821
1/2/2022,Michigan,9922576,494,121040,4016,823
1/3/2022,Michigan,9922576,453,121493,4029,794
1/4/2022,Michigan,9922576,584,122077,4240,823
1/5/2022,Michigan,9922576,598,122675,4326,814
1/6/2022,Michigan,9922576,582,123257,4394,816
1/7/2022,Michigan,9922576,631,123888,4605,857
1/8/2022,Michigan,9922576,602,124490,4525,829
1/9/2022,Michigan,9922576,529,125019,4582,840
1/10/2022,Michigan,9922576,504,125523,4739,850
1/11/2022,Michigan,9922576,539,126062,4741,848
1/12/2022,Michigan,9922576,598,126660,4654,813
1/13/2022,Michigan,9922576,614,127274,4669,787
1/14/2022,Michigan,9922576,619,127893,4730,791
1/15/2022,Michigan,9922576,560,128453,4581,804
1/16/2022,Michigan,9922576,435,128888,4534,794
1/17/2022,Michigan,9922576,479,129367,4571,796
1/18/2022,Michigan,9922576,581,129948,4640,800
1/19/2022,Michigan,9922576,543,130491,4550,799
1/20/2022,Michigan,9922576,536,131027,4449,761
1/21/2022,Michigan,9922576,526,131553,4296,746
1/22/2022,Michigan,9922576,437,131990,4083,715
1/23/2022,Michigan,9922576,405,132395,4052,708
1/24/2022,Michigan,9922576,393,132788,4060,724
1/25/2022,Michigan,9922576,464,133252,4006,692
1/26/2022,Michigan,9922576,443,133695,3864,681
1/27/2022,Michigan,9922576,426,134121,3670,651
1/28/2022,Michigan,9922576,412,134533,3549,614
1/29/2022,Michigan,9922576,372,134905,3372,605
1/30/2022,Michigan,9922576,329,135234,3361,595
1/31/2022,Michigan,9922576,299,135533,3289,588
2/1/2022,Michigan,9922576,395,135928,3167,570
2/2/2022,Michigan,9922576,378,136306,3083,572
2/3/2022,Michigan,9922576,324,136630,2986,568
2/4/2022,Michigan,9922576,324,136954,2815,527
2/5/2022,Michigan,9922576,318,137272,2595,515
2/6/2022,Michigan,9922576,274,137546,2569,511
2/7/2022,Michigan,9922576,271,137817,2580,525
2/8/2022,Michigan,9922576,301,138118,2509,479
2/9/2022,Michigan,9922576,301,138419,2509,479
7/1/2021,Minnesota,5489594,18,26319,109,22
7/2/2021,Minnesota,5489594,13,26332,95,24
7/3/2021,Minnesota,5489594,16,26348,92,23
7/4/2021,Minnesota,5489594,12,26360,99,21
7/5/2021,Minnesota,5489594,17,26377,105,23
7/6/2021,Minnesota,5489594,9,26386,99,24
7/7/2021,Minnesota,5489594,10,26396,94,23
7/8/2021,Minnesota,5489594,20,26416,108,24
7/9/2021,Minnesota,5489594,14,26430,102,23
7/10/2021,Minnesota,5489594,23,26453,99,26
7/11/2021,Minnesota,5489594,11,26464,104,23
7/12/2021,Minnesota,5489594,19,26483,105,23
7/13/2021,Minnesota,5489594,17,26500,99,22
7/14/2021,Minnesota,5489594,12,26512,91,19
7/15/2021,Minnesota,5489594,19,26531,93,19
7/16/2021,Minnesota,5489594,21,26552,102,20
7/17/2021,Minnesota,5489594,17,26569,100,23
7/18/2021,Minnesota,5489594,15,26584,105,23
7/19/2021,Minnesota,5489594,13,26597,111,25
7/20/2021,Minnesota,5489594,16,26613,119,29
7/21/2021,Minnesota,5489594,18,26631,111,27
7/22/2021,Minnesota,5489594,30,26661,125,34
7/23/2021,Minnesota,5489594,35,26696,155,39
7/24/2021,Minnesota,5489594,34,26730,157,38
7/25/2021,Minnesota,5489594,37,26767,169,44
7/26/2021,Minnesota,5489594,23,26790,169,52
7/27/2021,Minnesota,5489594,42,26832,204,57
7/28/2021,Minnesota,5489594,28,26860,211,58
7/29/2021,Minnesota,5489594,42,26902,233,65
7/30/2021,Minnesota,5489594,35,26937,234,69
7/31/2021,Minnesota,5489594,34,26971,242,67
8/1/2021,Minnesota,5489594,32,27003,252,65
8/2/2021,Minnesota,5489594,22,27025,255,75
8/3/2021,Minnesota,5489594,45,27070,273,81
8/4/2021,Minnesota,5489594,36,27106,274,81
8/5/2021,Minnesota,5489594,33,27139,270,80
8/6/2021,Minnesota,5489594,43,27182,305,87
8/7/2021,Minnesota,5489594,42,27224,310,88
8/8/2021,Minnesota,5489594,43,27267,318,86
8/9/2021,Minnesota,5489594,42,27309,347,95
8/10/2021,Minnesota,5489594,58,27367,348,97
8/11/2021,Minnesota,5489594,68,27435,381,103
8/12/2021,Minnesota,5489594,53,27488,394,112
8/13/2021,Minnesota,5489594,58,27546,416,110
8/14/2021,Minnesota,5489594,62,27608,407,101
8/15/2021,Minnesota,5489594,52,27660,420,102
8/16/2021,Minnesota,5489594,59,27719,442,117
8/17/2021,Minnesota,5489594,70,27789,468,127
8/18/2021,Minnesota,5489594,76,27865,480,123
8/19/2021,Minnesota,5489594,73,27938,485,127
8/20/2021,Minnesota,5489594,85,28023,522,139
8/21/2021,Minnesota,5489594,65,28088,525,152
8/22/2021,Minnesota,5489594,54,28142,528,147
8/23/2021,Minnesota,5489594,75,28217,555,156
8/24/2021,Minnesota,5489594,89,28306,589,166
8/25/2021,Minnesota,5489594,77,28383,597,171
8/26/2021,Minnesota,5489594,70,28453,605,171
8/27/2021,Minnesota,5489594,71,28524,607,168
8/28/2021,Minnesota,5489594,60,28584,596,165
8/29/2021,Minnesota,5489594,66,28650,595,159
8/30/2021,Minnesota,5489594,64,28714,606,169
8/31/2021,Minnesota,5489594,93,28807,632,176
9/1/2021,Minnesota,5489594,74,28881,649,170
9/2/2021,Minnesota,5489594,82,28963,641,169
9/3/2021,Minnesota,5489594,70,29033,633,163
9/4/2021,Minnesota,5489594,73,29106,631,175
9/5/2021,Minnesota,5489594,68,29174,646,180
9/6/2021,Minnesota,5489594,74,29248,649,178
9/7/2021,Minnesota,5489594,73,29321,673,179
9/8/2021,Minnesota,5489594,90,29411,686,184
9/9/2021,Minnesota,5489594,86,29497,711,189
9/10/2021,Minnesota,5489594,93,29590,699,193
9/11/2021,Minnesota,5489594,62,29652,655,191
9/12/2021,Minnesota,5489594,77,29729,693,193
9/13/2021,Minnesota,5489594,95,29824,763,211
9/14/2021,Minnesota,5489594,84,29908,732,211
9/15/2021,Minnesota,5489594,90,29998,743,213
9/16/2021,Minnesota,5489594,88,30086,741,214
9/17/2021,Minnesota,5489594,114,30200,775,233
9/18/2021,Minnesota,5489594,98,30298,780,216
9/19/2021,Minnesota,5489594,90,30388,806,231
9/20/2021,Minnesota,5489594,86,30474,807,226
9/21/2021,Minnesota,5489594,100,30574,811,218
9/22/2021,Minnesota,5489594,96,30670,800,218
9/23/2021,Minnesota,5489594,107,30777,776,217
9/24/2021,Minnesota,5489594,101,30878,775,215
9/25/2021,Minnesota,5489594,102,30980,768,211
9/26/2021,Minnesota,5489594,87,31067,763,203
9/27/2021,Minnesota,5489594,89,31156,783,199
9/28/2021,Minnesota,5489594,122,31278,818,209
9/29/2021,Minnesota,5489594,98,31376,807,211
9/30/2021,Minnesota,5489594,111,31487,822,216
10/1/2021,Minnesota,5489594,109,31596,838,217
10/2/2021,Minnesota,5489594,110,31706,831,212
10/3/2021,Minnesota,5489594,99,31805,846,213
10/4/2021,Minnesota,5489594,116,31921,863,224
10/5/2021,Minnesota,5489594,129,32050,879,228
10/6/2021,Minnesota,5489594,99,32149,894,237
10/7/2021,Minnesota,5489594,129,32278,889,239
10/8/2021,Minnesota,5489594,139,32417,931,244
10/9/2021,Minnesota,5489594,123,32540,925,241
10/10/2021,Minnesota,5489594,90,32630,946,246
10/11/2021,Minnesota,5489594,108,32738,971,256
10/12/2021,Minnesota,5489594,149,32887,1005,264
10/13/2021,Minnesota,5489594,126,33013,999,260
10/14/2021,Minnesota,5489594,109,33122,1016,258
10/15/2021,Minnesota,5489594,132,33254,1025,251
10/16/2021,Minnesota,5489594,110,33364,976,260
10/17/2021,Minnesota,5489594,99,33463,957,261
10/18/2021,Minnesota,5489594,89,33552,959,250
10/19/2021,Minnesota,5489594,105,33657,944,244
10/20/2021,Minnesota,5489594,115,33772,949,247
10/21/2021,Minnesota,5489594,105,33877,931,225
10/22/2021,Minnesota,5489594,114,33991,919,229
10/23/2021,Minnesota,5489594,115,34106,920,221
10/24/2021,Minnesota,5489594,99,34205,930,218
10/25/2021,Minnesota,5489594,113,34318,944,211
10/26/2021,Minnesota,5489594,110,34428,920,221
10/27/2021,Minnesota,5489594,114,34542,935,214
10/28/2021,Minnesota,5489594,109,34651,923,214
10/29/2021,Minnesota,5489594,135,34786,920,217
10/30/2021,Minnesota,5489594,106,34892,949,212
10/31/2021,Minnesota,5489594,92,34984,941,225
11/1/2021,Minnesota,5489594,111,35095,985,226
11/2/2021,Minnesota,5489594,132,35227,1012,230
11/3/2021,Minnesota,5489594,131,35358,1029,235
11/4/2021,Minnesota,5489594,121,35479,994,238
11/5/2021,Minnesota,5489594,131,35610,1000,231
11/6/2021,Minnesota,5489594,127,35737,997,237
11/7/2021,Minnesota,5489594,129,35866,1075,252
11/8/2021,Minnesota,5489594,121,35987,1135,251
11/9/2021,Minnesota,5489594,154,36141,1173,259
11/10/2021,Minnesota,5489594,143,36284,1198,285
11/11/2021,Minnesota,5489594,178,36462,1267,297
11/12/2021,Minnesota,5489594,186,36648,1303,315
11/13/2021,Minnesota,5489594,153,36801,1281,315
11/14/2021,Minnesota,5489594,129,36930,1321,307
11/15/2021,Minnesota,5489594,164,37094,1370,310
11/16/2021,Minnesota,5489594,182,37276,1406,325
11/17/2021,Minnesota,5489594,168,37444,1411,339
11/18/2021,Minnesota,5489594,160,37604,1449,346
11/19/2021,Minnesota,5489594,125,37729,1402,336
11/20/2021,Minnesota,5489594,167,37896,1397,341
11/21/2021,Minnesota,5489594,140,38036,1418,333
11/22/2021,Minnesota,5489594,163,38199,1446,325
11/23/2021,Minnesota,5489594,175,38374,1436,330
11/24/2021,Minnesota,5489594,205,38579,1488,334
11/25/2021,Minnesota,5489594,176,38755,1479,334
11/26/2021,Minnesota,5489594,146,38901,1496,347
11/27/2021,Minnesota,5489594,176,39077,1510,347
11/28/2021,Minnesota,5489594,173,39250,1548,349
11/29/2021,Minnesota,5489594,154,39404,1555,350
11/30/2021,Minnesota,5489594,179,39583,1579,363
12/1/2021,Minnesota,5489594,176,39759,1568,350
12/2/2021,Minnesota,5489594,201,39960,1582,359
12/3/2021,Minnesota,5489594,197,40157,1592,352
12/4/2021,Minnesota,5489594,210,40367,1600,345
12/5/2021,Minnesota,5489594,153,40520,1600,347
12/6/2021,Minnesota,5489594,166,40686,1651,342
12/7/2021,Minnesota,5489594,192,40878,1669,328
12/8/2021,Minnesota,5489594,198,41076,1682,339
12/9/2021,Minnesota,5489594,176,41252,1709,348
12/10/2021,Minnesota,5489594,188,41440,1709,352
12/11/2021,Minnesota,5489594,134,41574,1654,355
12/12/2021,Minnesota,5489594,144,41718,1680,355
12/13/2021,Minnesota,5489594,136,41854,1671,361
12/14/2021,Minnesota,5489594,179,42033,1673,379
12/15/2021,Minnesota,5489594,152,42185,1610,375
12/16/2021,Minnesota,5489594,149,42334,1576,379
12/17/2021,Minnesota,5489594,134,42468,1504,371
12/18/2021,Minnesota,5489594,150,42618,1492,369
12/19/2021,Minnesota,5489594,132,42750,1488,366
12/20/2021,Minnesota,5489594,140,42890,1486,359
12/21/2021,Minnesota,5489594,152,43042,1451,353
12/22/2021,Minnesota,5489594,158,43200,1443,348
12/23/2021,Minnesota,5489594,142,43342,1416,340
12/24/2021,Minnesota,5489594,169,43511,1408,343
12/25/2021,Minnesota,5489594,120,43631,1340,342
12/26/2021,Minnesota,5489594,103,43734,1366,344
12/27/2021,Minnesota,5489594,131,43865,1387,340
12/28/2021,Minnesota,5489594,141,44006,1364,335
12/29/2021,Minnesota,5489594,140,44146,1336,315
12/30/2021,Minnesota,5489594,164,44310,1338,291
12/31/2021,Minnesota,5489594,162,44472,1327,296
1/1/2022,Minnesota,5489594,156,44628,1326,302
1/2/2022,Minnesota,5489594,136,44764,1340,286
1/3/2022,Minnesota,5489594,140,44904,1381,296
1/4/2022,Minnesota,5489594,190,45094,1428,288
1/5/2022,Minnesota,5489594,218,45312,1511,275
1/6/2022,Minnesota,5489594,191,45503,1509,272
1/7/2022,Minnesota,5489594,180,45683,1482,257
1/8/2022,Minnesota,5489594,185,45868,1466,263
1/9/2022,Minnesota,5489594,199,46067,1522,262
1/10/2022,Minnesota,5489594,147,46214,1551,264
1/11/2022,Minnesota,5489594,183,46397,1532,257
1/12/2022,Minnesota,5489594,256,46653,1625,253
1/13/2022,Minnesota,5489594,198,46851,1653,263
1/14/2022,Minnesota,5489594,217,47068,1668,254
1/15/2022,Minnesota,5489594,196,47264,1619,238
1/16/2022,Minnesota,5489594,181,47445,1596,238
1/17/2022,Minnesota,5489594,185,47630,1639,254
1/18/2022,Minnesota,5489594,214,47844,1623,246
1/19/2022,Minnesota,5489594,235,48079,1659,253
1/20/2022,Minnesota,5489594,216,48295,1606,247
1/21/2022,Minnesota,5489594,225,48520,1603,246
1/22/2022,Minnesota,5489594,194,48714,1567,244
1/23/2022,Minnesota,5489594,173,48887,1536,235
1/24/2022,Minnesota,5489594,134,49021,1548,233
1/25/2022,Minnesota,5489594,243,49264,1587,235
1/26/2022,Minnesota,5489594,217,49481,1577,240
1/27/2022,Minnesota,5489594,191,49672,1521,221
1/28/2022,Minnesota,5489594,206,49878,1479,215
1/29/2022,Minnesota,5489594,185,50063,1421,206
1/30/2022,Minnesota,5489594,146,50209,1412,196
1/31/2022,Minnesota,5489594,142,50351,1393,197
2/1/2022,Minnesota,5489594,180,50531,1382,208
2/2/2022,Minnesota,5489594,140,50671,1367,195
2/3/2022,Minnesota,5489594,141,50812,1278,196
2/4/2022,Minnesota,5489594,142,50954,1262,200
2/5/2022,Minnesota,5489594,149,51103,1156,184
2/6/2022,Minnesota,5489594,102,51205,1147,183
2/7/2022,Minnesota,5489594,116,51321,1178,180
2/8/2022,Minnesota,5489594,153,51474,1177,181
2/9/2022,Minnesota,5489594,153,51627,1177,181
7/1/2021,Missouri,6083672,108,47966,772,278
7/2/2021,Missouri,6083672,109,48075,774,292
7/3/2021,Missouri,6083672,131,48206,804,303
7/4/2021,Missouri,6083672,93,48299,830,313
7/5/2021,Missouri,6083672,99,48398,861,316
7/6/2021,Missouri,6083672,119,48517,913,341
7/7/2021,Missouri,6083672,139,48656,986,360
7/8/2021,Missouri,6083672,133,48789,1009,370
7/9/2021,Missouri,6083672,143,48932,1049,391
7/10/2021,Missouri,6083672,154,49086,1055,391
7/11/2021,Missouri,6083672,141,49227,1106,399
7/12/2021,Missouri,6083672,153,49380,1157,425
7/13/2021,Missouri,6083672,176,49556,1184,434
7/14/2021,Missouri,6083672,167,49723,1232,449
7/15/2021,Missouri,6083672,143,49866,1243,456
7/16/2021,Missouri,6083672,151,50017,1230,450
7/17/2021,Missouri,6083672,174,50191,1271,467
7/18/2021,Missouri,6083672,157,50348,1317,477
7/19/2021,Missouri,6083672,172,50520,1361,496
7/20/2021,Missouri,6083672,215,50735,1445,503
7/21/2021,Missouri,6083672,207,50942,1493,505
7/22/2021,Missouri,6083672,227,51169,1502,501
7/23/2021,Missouri,6083672,222,51391,1568,506
7/24/2021,Missouri,6083672,199,51590,1532,509
7/25/2021,Missouri,6083672,191,51781,1546,519
7/26/2021,Missouri,6083672,189,51970,1632,537
7/27/2021,Missouri,6083672,254,52224,1709,573
7/28/2021,Missouri,6083672,245,52469,1729,586
7/29/2021,Missouri,6083672,262,52731,1782,594
7/30/2021,Missouri,6083672,275,53006,1837,621
7/31/2021,Missouri,6083672,299,53305,1853,622
8/1/2021,Missouri,6083672,223,53528,1915,630
8/2/2021,Missouri,6083672,182,53710,1917,650
8/3/2021,Missouri,6083672,267,53977,1959,651
8/4/2021,Missouri,6083672,250,54227,1997,657
8/5/2021,Missouri,6083672,272,54499,2013,671
8/6/2021,Missouri,6083672,275,54774,2026,649
8/7/2021,Missouri,6083672,234,55008,2023,665
8/8/2021,Missouri,6083672,245,55253,2054,658
8/9/2021,Missouri,6083672,246,55499,2121,701
8/10/2021,Missouri,6083672,283,55782,2124,701
8/11/2021,Missouri,6083672,256,56038,2173,705
8/12/2021,Missouri,6083672,284,56322,2220,701
8/13/2021,Missouri,6083672,286,56608,2234,708
8/14/2021,Missouri,6083672,261,56869,2210,701
8/15/2021,Missouri,6083672,245,57114,2185,688
8/16/2021,Missouri,6083672,234,57348,2188,683
8/17/2021,Missouri,6083672,264,57612,2232,700
8/18/2021,Missouri,6083672,265,57877,2264,713
8/19/2021,Missouri,6083672,285,58162,2254,703
8/20/2021,Missouri,6083672,267,58429,2250,707
8/21/2021,Missouri,6083672,206,58635,2175,691
8/22/2021,Missouri,6083672,196,58831,2191,694
8/23/2021,Missouri,6083672,225,59056,2177,699
8/24/2021,Missouri,6083672,256,59312,2182,698
8/25/2021,Missouri,6083672,211,59523,2155,702
8/26/2021,Missouri,6083672,230,59753,2131,692
8/27/2021,Missouri,6083672,225,59978,2118,697
8/28/2021,Missouri,6083672,224,60202,2041,663
8/29/2021,Missouri,6083672,167,60369,2027,660
8/30/2021,Missouri,6083672,170,60539,2026,631
8/31/2021,Missouri,6083672,208,60747,2004,634
9/1/2021,Missouri,6083672,199,60946,1972,601
9/2/2021,Missouri,6083672,231,61177,1956,616
9/3/2021,Missouri,6083672,205,61382,1928,615
9/4/2021,Missouri,6083672,179,61561,1803,577
9/5/2021,Missouri,6083672,170,61731,1797,573
9/6/2021,Missouri,6083672,158,61889,1801,573
9/7/2021,Missouri,6083672,177,62066,1841,567
9/8/2021,Missouri,6083672,232,62298,1888,554
9/9/2021,Missouri,6083672,184,62482,1864,560
9/10/2021,Missouri,6083672,191,62673,1798,538
9/11/2021,Missouri,6083672,163,62836,1749,536
9/12/2021,Missouri,6083672,150,62986,1747,537
9/13/2021,Missouri,6083672,165,63151,1732,525
9/14/2021,Missouri,6083672,197,63348,1706,519
9/15/2021,Missouri,6083672,164,63512,1712,509
9/16/2021,Missouri,6083672,151,63663,1699,511
9/17/2021,Missouri,6083672,168,63831,1666,486
9/18/2021,Missouri,6083672,149,63980,1595,478
9/19/2021,Missouri,6083672,129,64109,1547,462
9/20/2021,Missouri,6083672,150,64259,1543,484
9/21/2021,Missouri,6083672,172,64431,1550,494
9/22/2021,Missouri,6083672,148,64579,1521,484
9/23/2021,Missouri,6083672,174,64753,1489,463
9/24/2021,Missouri,6083672,132,64885,1455,443
9/25/2021,Missouri,6083672,143,65028,1409,448
9/26/2021,Missouri,6083672,120,65148,1375,429
9/27/2021,Missouri,6083672,117,65265,1383,433
9/28/2021,Missouri,6083672,154,65419,1360,437
9/29/2021,Missouri,6083672,117,65536,1313,424
9/30/2021,Missouri,6083672,106,65642,1245,397
10/1/2021,Missouri,6083672,116,65758,1217,381
10/2/2021,Missouri,6083672,118,65876,1204,384
10/3/2021,Missouri,6083672,93,65969,1189,376
10/4/2021,Missouri,6083672,101,66070,1204,379
10/5/2021,Missouri,6083672,111,66181,1173,380
10/6/2021,Missouri,6083672,110,66291,1153,376
10/7/2021,Missouri,6083672,105,66396,1105,366
10/8/2021,Missouri,6083672,112,66508,1057,356
10/9/2021,Missouri,6083672,111,66619,1008,342
10/10/2021,Missouri,6083672,108,66727,1011,352
10/11/2021,Missouri,6083672,80,66807,1011,342
10/12/2021,Missouri,6083672,107,66914,1005,340
10/13/2021,Missouri,6083672,97,67011,1001,345
10/14/2021,Missouri,6083672,115,67126,1009,338
10/15/2021,Missouri,6083672,116,67242,993,353
10/16/2021,Missouri,6083672,95,67337,951,333
10/17/2021,Missouri,6083672,68,67405,922,321
10/18/2021,Missouri,6083672,71,67476,933,322
10/19/2021,Missouri,6083672,93,67569,923,323
10/20/2021,Missouri,6083672,88,67657,931,318
10/21/2021,Missouri,6083672,75,67732,918,311
10/22/2021,Missouri,6083672,93,67825,910,294
10/23/2021,Missouri,6083672,70,67895,855,290
10/24/2021,Missouri,6083672,74,67969,841,288
10/25/2021,Missouri,6083672,77,68046,820,283
10/26/2021,Missouri,6083672,86,68132,820,276
10/27/2021,Missouri,6083672,81,68213,841,273
10/28/2021,Missouri,6083672,87,68300,838,269
10/29/2021,Missouri,6083672,97,68397,853,273
10/30/2021,Missouri,6083672,81,68478,831,261
10/31/2021,Missouri,6083672,50,68528,815,255
11/1/2021,Missouri,6083672,61,68589,787,251
11/2/2021,Missouri,6083672,100,68689,787,256
11/3/2021,Missouri,6083672,74,68763,786,258
11/4/2021,Missouri,6083672,84,68847,776,245
11/5/2021,Missouri,6083672,100,68947,769,235
11/6/2021,Missouri,6083672,85,69032,759,244
11/7/2021,Missouri,6083672,77,69109,754,239
11/8/2021,Missouri,6083672,79,69188,776,250
11/9/2021,Missouri,6083672,109,69297,806,256
11/10/2021,Missouri,6083672,97,69394,823,251
11/11/2021,Missouri,6083672,94,69488,818,243
11/12/2021,Missouri,6083672,92,69580,821,255
11/13/2021,Missouri,6083672,90,69670,804,261
11/14/2021,Missouri,6083672,78,69748,798,249
11/15/2021,Missouri,6083672,90,69838,814,259
11/16/2021,Missouri,6083672,108,69946,829,269
11/17/2021,Missouri,6083672,125,70071,865,283
11/18/2021,Missouri,6083672,134,70205,915,283
11/19/2021,Missouri,6083672,119,70324,917,277
11/20/2021,Missouri,6083672,117,70441,895,269
11/21/2021,Missouri,6083672,102,70543,919,272
11/22/2021,Missouri,6083672,124,70667,974,293
11/23/2021,Missouri,6083672,156,70823,1016,300
11/24/2021,Missouri,6083672,129,70952,1041,309
11/25/2021,Missouri,6083672,137,71089,1039,304
11/26/2021,Missouri,6083672,111,71200,1059,300
11/27/2021,Missouri,6083672,150,71350,1090,321
11/28/2021,Missouri,6083672,144,71494,1142,322
11/29/2021,Missouri,6083672,147,71641,1186,343
11/30/2021,Missouri,6083672,170,71811,1222,347
12/1/2021,Missouri,6083672,185,71996,1284,362
12/2/2021,Missouri,6083672,181,72177,1327,383
12/3/2021,Missouri,6083672,219,72396,1377,396
12/4/2021,Missouri,6083672,194,72590,1408,402
12/5/2021,Missouri,6083672,163,72753,1439,399
12/6/2021,Missouri,6083672,206,72959,1478,397
12/7/2021,Missouri,6083672,225,73184,1556,420
12/8/2021,Missouri,6083672,249,73433,1613,424
12/9/2021,Missouri,6083672,236,73669,1638,433
12/10/2021,Missouri,6083672,251,73920,1700,459
12/11/2021,Missouri,6083672,233,74153,1719,458
12/12/2021,Missouri,6083672,182,74335,1707,467
12/13/2021,Missouri,6083672,175,74510,1737,477
12/14/2021,Missouri,6083672,238,74748,1778,509
12/15/2021,Missouri,6083672,247,74995,1798,502
12/16/2021,Missouri,6083672,232,75227,1848,502
12/17/2021,Missouri,6083672,216,75443,1836,516
12/18/2021,Missouri,6083672,209,75652,1819,516
12/19/2021,Missouri,6083672,202,75854,1868,525
12/20/2021,Missouri,6083672,144,75998,1868,524
12/21/2021,Missouri,6083672,229,76227,1887,512
12/22/2021,Missouri,6083672,227,76454,1886,510
12/23/2021,Missouri,6083672,255,76709,1931,535
12/24/2021,Missouri,6083672,216,76925,1923,545
12/25/2021,Missouri,6083672,213,77138,1884,564
12/26/2021,Missouri,6083672,216,77354,1960,570
12/27/2021,Missouri,6083672,254,77608,2059,574
12/28/2021,Missouri,6083672,268,77876,2072,585
12/29/2021,Missouri,6083672,298,78174,2090,560
12/30/2021,Missouri,6083672,291,78465,2287,575
12/31/2021,Missouri,6083672,362,78827,2406,578
1/1/2022,Missouri,6083672,339,79166,2465,609
1/2/2022,Missouri,6083672,260,79426,2528,629
1/3/2022,Missouri,6083672,311,79737,2605,643
1/4/2022,Missouri,6083672,366,80103,2733,666
1/5/2022,Missouri,6083672,393,80496,2759,627
1/6/2022,Missouri,6083672,407,80903,3033,689
1/7/2022,Missouri,6083672,408,81311,3081,691
1/8/2022,Missouri,6083672,378,81689,3055,709
1/9/2022,Missouri,6083672,344,82033,3169,721
1/10/2022,Missouri,6083672,332,82365,3272,740
1/11/2022,Missouri,6083672,406,82771,3346,735
1/12/2022,Missouri,6083672,447,83218,3544,760
1/13/2022,Missouri,6083672,478,83696,3599,746
1/14/2022,Missouri,6083672,419,84115,3594,734
1/15/2022,Missouri,6083672,487,84602,3510,714
1/16/2022,Missouri,6083672,357,84959,3568,722
1/17/2022,Missouri,6083672,370,85329,3584,727
1/18/2022,Missouri,6083672,458,85787,3652,743
1/19/2022,Missouri,6083672,480,86267,3756,758
1/20/2022,Missouri,6083672,478,86745,3791,746
1/21/2022,Missouri,6083672,446,87191,3733,730
1/22/2022,Missouri,6083672,405,87596,3602,724
1/23/2022,Missouri,6083672,324,87920,3586,721
1/24/2022,Missouri,6083672,357,88277,3537,740
1/25/2022,Missouri,6083672,520,88797,3560,744
1/26/2022,Missouri,6083672,430,89227,3596,719
1/27/2022,Missouri,6083672,418,89645,3538,714
1/28/2022,Missouri,6083672,394,90039,3461,710
1/29/2022,Missouri,6083672,361,90400,3260,668
1/30/2022,Missouri,6083672,316,90716,3181,652
1/31/2022,Missouri,6083672,323,91039,3200,669
2/1/2022,Missouri,6083672,380,91419,3158,676
2/2/2022,Missouri,6083672,358,91777,3020,646
2/3/2022,Missouri,6083672,278,92055,2984,634
2/4/2022,Missouri,6083672,236,92291,2937,618
2/5/2022,Missouri,6083672,298,92589,2745,597
2/6/2022,Missouri,6083672,247,92836,2723,591
2/7/2022,Missouri,6083672,281,93117,2718,607
2/8/2022,Missouri,6083672,283,93400,2633,588
2/9/2022,Missouri,6083672,283,93683,2633,588
7/1/2021,Mississippi,2992333,37,25870,137,41
7/2/2021,Mississippi,2992333,31,25901,138,39
7/3/2021,Mississippi,2992333,21,25922,138,37
7/4/2021,Mississippi,2992333,33,25955,146,38
7/5/2021,Mississippi,2992333,26,25981,159,35
7/6/2021,Mississippi,2992333,37,26018,173,44
7/7/2021,Mississippi,2992333,36,26054,177,45
7/8/2021,Mississippi,2992333,36,26090,186,52
7/9/2021,Mississippi,2992333,48,26138,200,55
7/10/2021,Mississippi,2992333,47,26185,225,59
7/11/2021,Mississippi,2992333,43,26228,241,70
7/12/2021,Mississippi,2992333,42,26270,251,69
7/13/2021,Mississippi,2992333,43,26313,250,71
7/14/2021,Mississippi,2992333,50,26363,262,78
7/15/2021,Mississippi,2992333,58,26421,294,85
7/16/2021,Mississippi,2992333,57,26478,337,105
7/17/2021,Mississippi,2992333,67,26545,345,112
7/18/2021,Mississippi,2992333,58,26603,369,116
7/19/2021,Mississippi,2992333,63,26666,392,115
7/20/2021,Mississippi,2992333,76,26742,405,120
7/21/2021,Mississippi,2992333,62,26804,433,131
7/22/2021,Mississippi,2992333,95,26899,492,148
7/23/2021,Mississippi,2992333,77,26976,518,152
7/24/2021,Mississippi,2992333,79,27055,545,149
7/25/2021,Mississippi,2992333,73,27128,594,162
7/26/2021,Mississippi,2992333,81,27209,628,169
7/27/2021,Mississippi,2992333,126,27335,690,176
7/28/2021,Mississippi,2992333,117,27452,736,190
7/29/2021,Mississippi,2992333,118,27570,795,211
7/30/2021,Mississippi,2992333,120,27690,847,226
7/31/2021,Mississippi,2992333,124,27814,914,245
8/1/2021,Mississippi,2992333,137,27951,958,266
8/2/2021,Mississippi,2992333,139,28090,1035,287
8/3/2021,Mississippi,2992333,157,28247,1073,302
8/4/2021,Mississippi,2992333,167,28414,1155,319
8/5/2021,Mississippi,2992333,183,28597,1232,351
8/6/2021,Mississippi,2992333,174,28771,1315,371
8/7/2021,Mississippi,2992333,154,28925,1306,364
8/8/2021,Mississippi,2992333,166,29091,1388,377
8/9/2021,Mississippi,2992333,155,29246,1475,380
8/10/2021,Mississippi,2992333,221,29467,1522,397
8/11/2021,Mississippi,2992333,193,29660,1549,413
8/12/2021,Mississippi,2992333,225,29885,1594,424
8/13/2021,Mississippi,2992333,195,30080,1598,447
8/14/2021,Mississippi,2992333,206,30286,1611,465
8/15/2021,Mississippi,2992333,156,30442,1638,466
8/16/2021,Mississippi,2992333,168,30610,1688,467
8/17/2021,Mississippi,2992333,208,30818,1720,484
8/18/2021,Mississippi,2992333,201,31019,1727,490
8/19/2021,Mississippi,2992333,208,31227,1768,501
8/20/2021,Mississippi,2992333,183,31410,1766,522
8/21/2021,Mississippi,2992333,170,31580,1744,527
8/22/2021,Mississippi,2992333,158,31738,1751,535
8/23/2021,Mississippi,2992333,161,31899,1741,546
8/24/2021,Mississippi,2992333,180,32079,1729,545
8/25/2021,Mississippi,2992333,166,32245,1728,528
8/26/2021,Mississippi,2992333,170,32415,1709,519
8/27/2021,Mississippi,2992333,143,32558,1677,507
8/28/2021,Mississippi,2992333,170,32728,1643,522
8/29/2021,Mississippi,2992333,142,32870,1625,522
8/30/2021,Mississippi,2992333,132,33002,1628,515
8/31/2021,Mississippi,2992333,159,33161,1626,515
9/1/2021,Mississippi,2992333,161,33322,1594,518
9/2/2021,Mississippi,2992333,170,33492,1578,518
9/3/2021,Mississippi,2992333,130,33622,1519,520
9/4/2021,Mississippi,2992333,127,33749,1483,511
9/5/2021,Mississippi,2992333,112,33861,1488,505
9/6/2021,Mississippi,2992333,113,33974,1463,480
9/7/2021,Mississippi,2992333,123,34097,1434,469
9/8/2021,Mississippi,2992333,128,34225,1395,453
9/9/2021,Mississippi,2992333,122,34347,1358,437
9/10/2021,Mississippi,2992333,104,34451,1299,420
9/11/2021,Mississippi,2992333,99,34550,1262,421
9/12/2021,Mississippi,2992333,80,34630,1198,401
9/13/2021,Mississippi,2992333,70,34700,1194,416
9/14/2021,Mississippi,2992333,98,34798,1167,400
9/15/2021,Mississippi,2992333,74,34872,1085,378
9/16/2021,Mississippi,2992333,84,34956,1046,371
9/17/2021,Mississippi,2992333,68,35024,957,340
9/18/2021,Mississippi,2992333,72,35096,920,327
9/19/2021,Mississippi,2992333,64,35160,905,317
9/20/2021,Mississippi,2992333,74,35234,900,312
9/21/2021,Mississippi,2992333,74,35308,840,296
9/22/2021,Mississippi,2992333,76,35384,824,280
9/23/2021,Mississippi,2992333,61,35445,785,265
9/24/2021,Mississippi,2992333,75,35520,745,270
9/25/2021,Mississippi,2992333,52,35572,713,246
9/26/2021,Mississippi,2992333,41,35613,683,244
9/27/2021,Mississippi,2992333,49,35662,672,231
9/28/2021,Mississippi,2992333,55,35717,655,225
9/29/2021,Mississippi,2992333,55,35772,622,211
9/30/2021,Mississippi,2992333,43,35815,600,206
10/1/2021,Mississippi,2992333,35,35850,569,198
10/2/2021,Mississippi,2992333,43,35893,527,189
10/3/2021,Mississippi,2992333,41,35934,518,188
10/4/2021,Mississippi,2992333,42,35976,506,184
10/5/2021,Mississippi,2992333,46,36022,494,173
10/6/2021,Mississippi,2992333,42,36064,488,166
10/7/2021,Mississippi,2992333,35,36099,477,168
10/8/2021,Mississippi,2992333,30,36129,457,155
10/9/2021,Mississippi,2992333,32,36161,439,150
10/10/2021,Mississippi,2992333,29,36190,422,147
10/11/2021,Mississippi,2992333,15,36205,413,137
10/12/2021,Mississippi,2992333,36,36241,404,133
10/13/2021,Mississippi,2992333,37,36278,385,139
10/14/2021,Mississippi,2992333,27,36305,363,124
10/15/2021,Mississippi,2992333,21,36326,355,113
10/16/2021,Mississippi,2992333,38,36364,338,83
10/17/2021,Mississippi,2992333,21,36385,343,108
10/18/2021,Mississippi,2992333,34,36419,349,109
10/19/2021,Mississippi,2992333,34,36453,331,111
10/20/2021,Mississippi,2992333,45,36498,346,111
10/21/2021,Mississippi,2992333,37,36535,354,109
10/22/2021,Mississippi,2992333,38,36573,336,103
10/23/2021,Mississippi,2992333,22,36595,311,98
10/24/2021,Mississippi,2992333,28,36623,304,93
10/25/2021,Mississippi,2992333,21,36644,286,101
10/26/2021,Mississippi,2992333,21,36665,271,99
10/27/2021,Mississippi,2992333,23,36688,258,100
10/28/2021,Mississippi,2992333,23,36711,250,94
10/29/2021,Mississippi,2992333,17,36728,239,90
10/30/2021,Mississippi,2992333,26,36754,233,85
10/31/2021,Mississippi,2992333,16,36770,229,86
11/1/2021,Mississippi,2992333,14,36784,228,84
11/2/2021,Mississippi,2992333,24,36808,227,83
11/3/2021,Mississippi,2992333,27,36835,227,87
11/4/2021,Mississippi,2992333,18,36853,208,82
11/5/2021,Mississippi,2992333,14,36867,194,77
11/6/2021,Mississippi,2992333,18,36885,191,76
11/7/2021,Mississippi,2992333,6,36891,182,68
11/8/2021,Mississippi,2992333,17,36908,190,75
11/9/2021,Mississippi,2992333,10,36918,183,69
11/10/2021,Mississippi,2992333,14,36932,180,69
11/11/2021,Mississippi,2992333,18,36950,178,59
11/12/2021,Mississippi,2992333,15,36965,174,54
11/13/2021,Mississippi,2992333,18,36983,167,54
11/14/2021,Mississippi,2992333,18,37001,174,58
11/15/2021,Mississippi,2992333,19,37020,170,54
11/16/2021,Mississippi,2992333,20,37040,174,57
11/17/2021,Mississippi,2992333,21,37061,173,58
11/18/2021,Mississippi,2992333,9,37070,175,65
11/19/2021,Mississippi,2992333,18,37088,171,66
11/20/2021,Mississippi,2992333,16,37104,168,60
11/21/2021,Mississippi,2992333,18,37122,165,63
11/22/2021,Mississippi,2992333,20,37142,174,67
11/23/2021,Mississippi,2992333,22,37164,181,65
11/24/2021,Mississippi,2992333,21,37185,181,60
11/25/2021,Mississippi,2992333,20,37205,184,59
11/26/2021,Mississippi,2992333,16,37221,187,59
11/27/2021,Mississippi,2992333,26,37247,197,60
11/28/2021,Mississippi,2992333,16,37263,196,57
11/29/2021,Mississippi,2992333,27,37290,220,58
11/30/2021,Mississippi,2992333,24,37314,198,55
12/1/2021,Mississippi,2992333,30,37344,211,59
12/2/2021,Mississippi,2992333,21,37365,198,58
12/3/2021,Mississippi,2992333,26,37391,213,60
12/4/2021,Mississippi,2992333,22,37413,204,66
12/5/2021,Mississippi,2992333,21,37434,207,64
12/6/2021,Mississippi,2992333,20,37454,216,62
12/7/2021,Mississippi,2992333,34,37488,233,66
12/8/2021,Mississippi,2992333,37,37525,235,71
12/9/2021,Mississippi,2992333,25,37550,228,72
12/10/2021,Mississippi,2992333,18,37568,235,70
12/11/2021,Mississippi,2992333,28,37596,227,71
12/12/2021,Mississippi,2992333,15,37611,228,69
12/13/2021,Mississippi,2992333,28,37639,243,73
12/14/2021,Mississippi,2992333,26,37665,242,74
12/15/2021,Mississippi,2992333,32,37697,249,77
12/16/2021,Mississippi,2992333,25,37722,241,75
12/17/2021,Mississippi,2992333,21,37743,249,76
12/18/2021,Mississippi,2992333,27,37770,260,79
12/19/2021,Mississippi,2992333,21,37791,267,81
12/20/2021,Mississippi,2992333,22,37813,270,81
12/21/2021,Mississippi,2992333,39,37852,272,85
12/22/2021,Mississippi,2992333,28,37880,271,90
12/23/2021,Mississippi,2992333,27,37907,284,89
12/24/2021,Mississippi,2992333,39,37946,295,90
12/25/2021,Mississippi,2992333,48,37994,311,92
12/26/2021,Mississippi,2992333,45,38039,323,95
12/27/2021,Mississippi,2992333,82,38121,400,103
12/28/2021,Mississippi,2992333,108,38229,457,108
12/29/2021,Mississippi,2992333,115,38344,515,120
12/30/2021,Mississippi,2992333,118,38462,587,127
12/31/2021,Mississippi,2992333,103,38565,612,126
1/1/2022,Mississippi,2992333,103,38668,633,132
1/2/2022,Mississippi,2992333,103,38771,698,134
1/3/2022,Mississippi,2992333,117,38888,733,149
1/4/2022,Mississippi,2992333,133,39021,792,159
1/5/2022,Mississippi,2992333,203,39224,919,183
1/6/2022,Mississippi,2992333,191,39415,1040,195
1/7/2022,Mississippi,2992333,181,39596,1079,202
1/8/2022,Mississippi,2992333,161,39757,1099,208
1/9/2022,Mississippi,2992333,156,39913,1121,213
1/10/2022,Mississippi,2992333,194,40107,1244,240
1/11/2022,Mississippi,2992333,214,40321,1293,238
1/12/2022,Mississippi,2992333,176,40497,1346,248
1/13/2022,Mississippi,2992333,215,40712,1389,254
1/14/2022,Mississippi,2992333,220,40932,1433,270
1/15/2022,Mississippi,2992333,176,41108,1431,281
1/16/2022,Mississippi,2992333,140,41248,1433,290
1/17/2022,Mississippi,2992333,176,41424,1493,287
1/18/2022,Mississippi,2992333,210,41634,1557,290
1/19/2022,Mississippi,2992333,213,41847,1606,288
1/20/2022,Mississippi,2992333,220,42067,1634,293
1/21/2022,Mississippi,2992333,209,42276,1581,305
1/22/2022,Mississippi,2992333,198,42474,1558,304
1/23/2022,Mississippi,2992333,155,42629,1572,322
1/24/2022,Mississippi,2992333,179,42808,1632,334
1/25/2022,Mississippi,2992333,227,43035,1653,334
1/26/2022,Mississippi,2992333,222,43257,1665,340
1/27/2022,Mississippi,2992333,172,43429,1675,338
1/28/2022,Mississippi,2992333,183,43612,1597,326
1/29/2022,Mississippi,2992333,175,43787,1511,322
1/30/2022,Mississippi,2992333,104,43891,1484,321
1/31/2022,Mississippi,2992333,174,44065,1515,319
2/1/2022,Mississippi,2992333,202,44267,1470,310
2/2/2022,Mississippi,2992333,179,44446,1451,309
2/3/2022,Mississippi,2992333,148,44594,1406,287
2/4/2022,Mississippi,2992333,129,44723,1321,275
2/5/2022,Mississippi,2992333,94,44817,1238,278
2/6/2022,Mississippi,2992333,89,44906,1210,275
2/7/2022,Mississippi,2992333,143,45049,1162,263
2/8/2022,Mississippi,2992333,132,45181,1129,250
2/9/2022,Mississippi,2992333,124,45305,1105,243
7/1/2021,Montana,1032949,18,10467,57,15
7/2/2021,Montana,1032949,7,10474,42,13
7/3/2021,Montana,1032949,7,10481,40,11
7/4/2021,Montana,1032949,5,10486,39,11
7/5/2021,Montana,1032949,7,10493,41,12
7/6/2021,Montana,1032949,12,10505,47,11
7/7/2021,Montana,1032949,12,10517,45,9
7/8/2021,Montana,1032949,13,10530,48,11
7/9/2021,Montana,1032949,16,10546,54,9
7/10/2021,Montana,1032949,14,10560,52,9
7/11/2021,Montana,1032949,15,10575,58,11
7/12/2021,Montana,1032949,15,10590,57,10
7/13/2021,Montana,1032949,21,10611,60,11
7/14/2021,Montana,1032949,15,10626,63,15
7/15/2021,Montana,1032949,10,10636,59,15
7/16/2021,Montana,1032949,13,10649,60,14
7/17/2021,Montana,1032949,9,10658,57,14
7/18/2021,Montana,1032949,12,10670,56,15
7/19/2021,Montana,1032949,12,10682,57,16
7/20/2021,Montana,1032949,19,10701,62,19
7/21/2021,Montana,1032949,10,10711,71,20
7/22/2021,Montana,1032949,23,10734,73,18
7/23/2021,Montana,1032949,18,10752,82,18
7/24/2021,Montana,1032949,12,10764,83,21
7/25/2021,Montana,1032949,10,10774,80,18
7/26/2021,Montana,1032949,13,10787,82,19
7/27/2021,Montana,1032949,25,10812,89,27
7/28/2021,Montana,1032949,24,10836,102,25
7/29/2021,Montana,1032949,22,10858,102,27
7/30/2021,Montana,1032949,30,10888,110,24
7/31/2021,Montana,1032949,26,10914,106,24
8/1/2021,Montana,1032949,25,10939,113,29
8/2/2021,Montana,1032949,29,10968,118,30
8/3/2021,Montana,1032949,38,11006,129,30
8/4/2021,Montana,1032949,27,11033,135,35
8/5/2021,Montana,1032949,25,11058,140,37
8/6/2021,Montana,1032949,35,11093,156,38
8/7/2021,Montana,1032949,21,11114,146,36
8/8/2021,Montana,1032949,28,11142,150,34
8/9/2021,Montana,1032949,29,11171,153,36
8/10/2021,Montana,1032949,41,11212,166,49
8/11/2021,Montana,1032949,48,11260,177,51
8/12/2021,Montana,1032949,41,11301,178,47
8/13/2021,Montana,1032949,29,11330,176,52
8/14/2021,Montana,1032949,37,11367,192,53
8/15/2021,Montana,1032949,36,11403,190,53
8/16/2021,Montana,1032949,44,11447,205,56
8/17/2021,Montana,1032949,49,11496,208,53
8/18/2021,Montana,1032949,44,11540,205,55
8/19/2021,Montana,1032949,36,11576,197,48
8/20/2021,Montana,1032949,48,11624,200,45
8/21/2021,Montana,1032949,59,11683,220,41
8/22/2021,Montana,1032949,50,11733,236,49
8/23/2021,Montana,1032949,54,11787,253,53
8/24/2021,Montana,1032949,42,11829,244,55
8/25/2021,Montana,1032949,40,11869,222,53
8/26/2021,Montana,1032949,50,11919,235,56
8/27/2021,Montana,1032949,67,11986,233,56
8/28/2021,Montana,1032949,49,12035,239,66
8/29/2021,Montana,1032949,60,12095,250,72
8/30/2021,Montana,1032949,55,12150,256,73
8/31/2021,Montana,1032949,62,12212,270,72
9/1/2021,Montana,1032949,55,12267,270,74
9/2/2021,Montana,1032949,56,12323,279,75
9/3/2021,Montana,1032949,75,12398,282,74
9/4/2021,Montana,1032949,73,12471,297,79
9/5/2021,Montana,1032949,55,12526,301,76
9/6/2021,Montana,1032949,70,12596,300,78
9/7/2021,Montana,1032949,78,12674,319,91
9/8/2021,Montana,1032949,98,12772,337,92
9/9/2021,Montana,1032949,86,12858,359,93
9/10/2021,Montana,1032949,78,12936,362,93
9/11/2021,Montana,1032949,96,13032,347,85
9/12/2021,Montana,1032949,83,13115,353,96
9/13/2021,Montana,1032949,84,13199,385,102
9/14/2021,Montana,1032949,95,13294,385,106
9/15/2021,Montana,1032949,80,13374,374,102
9/16/2021,Montana,1032949,96,13470,378,105
9/17/2021,Montana,1032949,83,13553,364,107
9/18/2021,Montana,1032949,75,13628,365,103
9/19/2021,Montana,1032949,76,13704,384,101
9/20/2021,Montana,1032949,86,13790,392,108
9/21/2021,Montana,1032949,107,13897,414,112
9/22/2021,Montana,1032949,103,14000,431,109
9/23/2021,Montana,1032949,103,14103,432,109
9/24/2021,Montana,1032949,81,14184,415,109
9/25/2021,Montana,1032949,95,14279,433,106
9/26/2021,Montana,1032949,90,14369,432,108
9/27/2021,Montana,1032949,94,14463,450,105
9/28/2021,Montana,1032949,101,14564,451,105
9/29/2021,Montana,1032949,90,14654,436,109
9/30/2021,Montana,1032949,90,14744,431,93
10/1/2021,Montana,1032949,109,14853,435,97
10/2/2021,Montana,1032949,105,14958,441,106
10/3/2021,Montana,1032949,98,15056,423,97
10/4/2021,Montana,1032949,107,15163,430,106
10/5/2021,Montana,1032949,133,15296,458,116
10/6/2021,Montana,1032949,113,15409,471,119
10/7/2021,Montana,1032949,117,15526,476,119
10/8/2021,Montana,1032949,114,15640,489,117
10/9/2021,Montana,1032949,131,15771,491,108
10/10/2021,Montana,1032949,100,15871,487,116
10/11/2021,Montana,1032949,97,15968,490,116
10/12/2021,Montana,1032949,118,16086,513,122
10/13/2021,Montana,1032949,88,16174,487,126
10/14/2021,Montana,1032949,96,16270,484,121
10/15/2021,Montana,1032949,96,16366,474,122
10/16/2021,Montana,1032949,94,16460,458,116
10/17/2021,Montana,1032949,76,16536,454,116
10/18/2021,Montana,1032949,85,16621,465,117
10/19/2021,Montana,1032949,110,16731,459,118
10/20/2021,Montana,1032949,92,16823,444,118
10/21/2021,Montana,1032949,106,16929,437,117
10/22/2021,Montana,1032949,94,17023,457,121
10/23/2021,Montana,1032949,106,17129,463,123
10/24/2021,Montana,1032949,57,17186,454,121
10/25/2021,Montana,1032949,78,17264,463,119
10/26/2021,Montana,1032949,90,17354,474,119
10/27/2021,Montana,1032949,114,17468,448,120
10/28/2021,Montana,1032949,131,17599,432,114
10/29/2021,Montana,1032949,74,17673,420,115
10/30/2021,Montana,1032949,89,17762,412,116
10/31/2021,Montana,1032949,41,17803,390,111
11/1/2021,Montana,1032949,60,17863,376,106
11/2/2021,Montana,1032949,58,17921,367,107
11/3/2021,Montana,1032949,77,17998,375,111
11/4/2021,Montana,1032949,75,18073,364,101
11/5/2021,Montana,1032949,82,18155,352,99
11/6/2021,Montana,1032949,83,18238,364,92
11/7/2021,Montana,1032949,66,18304,382,96
11/8/2021,Montana,1032949,52,18356,371,101
11/9/2021,Montana,1032949,67,18423,372,99
11/10/2021,Montana,1032949,76,18499,362,95
11/11/2021,Montana,1032949,63,18562,336,95
11/12/2021,Montana,1032949,72,18634,314,95
11/13/2021,Montana,1032949,75,18709,324,95
11/14/2021,Montana,1032949,60,18769,316,86
11/15/2021,Montana,1032949,50,18819,313,92
11/16/2021,Montana,1032949,74,18893,317,89
11/17/2021,Montana,1032949,66,18959,314,89
11/18/2021,Montana,1032949,51,19010,284,85
11/19/2021,Montana,1032949,60,19070,275,79
11/20/2021,Montana,1032949,65,19135,281,80
11/21/2021,Montana,1032949,37,19172,268,81
11/22/2021,Montana,1032949,44,19216,277,77
11/23/2021,Montana,1032949,54,19270,264,68
11/24/2021,Montana,1032949,56,19326,240,62
11/25/2021,Montana,1032949,39,19365,224,58
11/26/2021,Montana,1032949,31,19396,222,61
11/27/2021,Montana,1032949,42,19438,218,60
11/28/2021,Montana,1032949,35,19473,216,61
11/29/2021,Montana,1032949,44,19517,223,63
11/30/2021,Montana,1032949,44,19561,228,65
12/1/2021,Montana,1032949,45,19606,205,69
12/2/2021,Montana,1032949,33,19639,199,64
12/3/2021,Montana,1032949,42,19681,199,63
12/4/2021,Montana,1032949,33,19714,199,60
12/5/2021,Montana,1032949,37,19751,199,57
12/6/2021,Montana,1032949,32,19783,191,63
12/7/2021,Montana,1032949,42,19825,187,63
12/8/2021,Montana,1032949,23,19848,172,63
12/9/2021,Montana,1032949,34,19882,175,58
12/10/2021,Montana,1032949,31,19913,166,54
12/11/2021,Montana,1032949,34,19947,163,51
12/12/2021,Montana,1032949,24,19971,158,54
12/13/2021,Montana,1032949,25,19996,159,49
12/14/2021,Montana,1032949,36,20032,155,46
12/15/2021,Montana,1032949,28,20060,156,43
12/16/2021,Montana,1032949,19,20079,141,43
12/17/2021,Montana,1032949,20,20099,136,40
12/18/2021,Montana,1032949,10,20109,126,44
12/19/2021,Montana,1032949,12,20121,125,44
12/20/2021,Montana,1032949,22,20143,128,44
12/21/2021,Montana,1032949,16,20159,124,44
12/22/2021,Montana,1032949,19,20178,111,44
12/23/2021,Montana,1032949,19,20197,114,43
12/24/2021,Montana,1032949,25,20222,116,48
12/25/2021,Montana,1032949,19,20241,120,48
12/26/2021,Montana,1032949,18,20259,118,49
12/27/2021,Montana,1032949,15,20274,127,51
12/28/2021,Montana,1032949,17,20291,126,43
12/29/2021,Montana,1032949,30,20321,132,41
12/30/2021,Montana,1032949,29,20350,136,40
12/31/2021,Montana,1032949,25,20375,143,42
1/1/2022,Montana,1032949,31,20406,133,43
1/2/2022,Montana,1032949,23,20429,132,40
1/3/2022,Montana,1032949,36,20465,140,44
1/4/2022,Montana,1032949,54,20519,147,39
1/5/2022,Montana,1032949,56,20575,154,39
1/6/2022,Montana,1032949,41,20616,147,44
1/7/2022,Montana,1032949,55,20671,163,43
1/8/2022,Montana,1032949,65,20736,158,37
1/9/2022,Montana,1032949,37,20773,159,36
1/10/2022,Montana,1032949,38,20811,169,36
1/11/2022,Montana,1032949,66,20877,175,34
1/12/2022,Montana,1032949,83,20960,197,46
1/13/2022,Montana,1032949,75,21035,202,39
1/14/2022,Montana,1032949,90,21125,218,39
1/15/2022,Montana,1032949,75,21200,235,30
1/16/2022,Montana,1032949,72,21272,242,34
1/17/2022,Montana,1032949,63,21335,246,39
1/18/2022,Montana,1032949,79,21414,255,38
1/19/2022,Montana,1032949,82,21496,304,44
1/20/2022,Montana,1032949,81,21577,316,40
1/21/2022,Montana,1032949,69,21646,326,40
1/22/2022,Montana,1032949,50,21696,312,38
1/23/2022,Montana,1032949,67,21763,334,41
1/24/2022,Montana,1032949,91,21854,340,46
1/25/2022,Montana,1032949,88,21942,340,51
1/26/2022,Montana,1032949,92,22034,324,46
1/27/2022,Montana,1032949,67,22101,316,48
1/28/2022,Montana,1032949,69,22170,307,41
1/29/2022,Montana,1032949,62,22232,295,43
1/30/2022,Montana,1032949,66,22298,295,48
1/31/2022,Montana,1032949,82,22380,328,55
2/1/2022,Montana,1032949,88,22468,343,50
2/2/2022,Montana,1032949,83,22551,369,53
2/3/2022,Montana,1032949,69,22620,364,57
2/4/2022,Montana,1032949,71,22691,354,58
2/5/2022,Montana,1032949,68,22759,343,53
2/6/2022,Montana,1032949,65,22824,357,54
2/7/2022,Montana,1032949,59,22883,350,55
2/8/2022,Montana,1032949,69,22952,327,57
2/9/2022,Montana,1032949,69,23021,327,57
7/1/2021,North Carolina,10042802,46,60733,339,96
7/2/2021,North Carolina,10042802,57,60790,381,101
7/3/2021,North Carolina,10042802,38,60828,375,108
7/4/2021,North Carolina,10042802,38,60866,378,112
7/5/2021,North Carolina,10042802,35,60901,388,99
7/6/2021,North Carolina,10042802,60,60961,371,110
7/7/2021,North Carolina,10042802,40,61001,375,104
7/8/2021,North Carolina,10042802,45,61046,385,116
7/9/2021,North Carolina,10042802,57,61103,365,115
7/10/2021,North Carolina,10042802,56,61159,384,113
7/11/2021,North Carolina,10042802,46,61205,395,122
7/12/2021,North Carolina,10042802,50,61255,416,136
7/13/2021,North Carolina,10042802,81,61336,434,148
7/14/2021,North Carolina,10042802,51,61387,459,151
7/15/2021,North Carolina,10042802,67,61454,484,161
7/16/2021,North Carolina,10042802,96,61550,515,164
7/17/2021,North Carolina,10042802,80,61630,527,169
7/18/2021,North Carolina,10042802,86,61716,540,183
7/19/2021,North Carolina,10042802,79,61795,598,200
7/20/2021,North Carolina,10042802,98,61893,621,204
7/21/2021,North Carolina,10042802,110,62003,682,201
7/22/2021,North Carolina,10042802,124,62127,748,211
7/23/2021,North Carolina,10042802,114,62241,802,209
7/24/2021,North Carolina,10042802,134,62375,822,216
7/25/2021,North Carolina,10042802,110,62485,868,234
7/26/2021,North Carolina,10042802,134,62619,952,248
7/27/2021,North Carolina,10042802,153,62772,1001,258
7/28/2021,North Carolina,10042802,146,62918,1036,274
7/29/2021,North Carolina,10042802,155,63073,1072,301
7/30/2021,North Carolina,10042802,169,63242,1137,316
7/31/2021,North Carolina,10042802,176,63418,1185,339
8/1/2021,North Carolina,10042802,184,63602,1247,373
8/2/2021,North Carolina,10042802,166,63768,1338,386
8/3/2021,North Carolina,10042802,217,63985,1446,401
8/4/2021,North Carolina,10042802,220,64205,1531,423
8/5/2021,North Carolina,10042802,214,64419,1584,432
8/6/2021,North Carolina,10042802,230,64649,1609,446
8/7/2021,North Carolina,10042802,229,64878,1725,476
8/8/2021,North Carolina,10042802,256,65134,1822,518
8/9/2021,North Carolina,10042802,253,65387,1960,566
8/10/2021,North Carolina,10042802,311,65698,2079,602
8/11/2021,North Carolina,10042802,303,66001,2226,629
8/12/2021,North Carolina,10042802,326,66327,2317,666
8/13/2021,North Carolina,10042802,310,66637,2398,674
8/14/2021,North Carolina,10042802,322,66959,2464,676
8/15/2021,North Carolina,10042802,301,67260,2487,695
8/16/2021,North Carolina,10042802,304,67564,2639,729
8/17/2021,North Carolina,10042802,363,67927,2714,748
8/18/2021,North Carolina,10042802,363,68290,2863,755
8/19/2021,North Carolina,10042802,368,68658,2923,787
8/20/2021,North Carolina,10042802,353,69011,2994,803
8/21/2021,North Carolina,10042802,357,69368,3011,824
8/22/2021,North Carolina,10042802,349,69717,3107,841
8/23/2021,North Carolina,10042802,350,70067,3223,863
8/24/2021,North Carolina,10042802,393,70460,3297,885
8/25/2021,North Carolina,10042802,377,70837,3360,917
8/26/2021,North Carolina,10042802,366,71203,3424,951
8/27/2021,North Carolina,10042802,396,71599,3428,966
8/28/2021,North Carolina,10042802,389,71988,3310,979
8/29/2021,North Carolina,10042802,328,72316,3423,961
8/30/2021,North Carolina,10042802,421,72737,3362,977
8/31/2021,North Carolina,10042802,412,73149,3562,958
9/1/2021,North Carolina,10042802,387,73536,3579,950
9/2/2021,North Carolina,10042802,379,73915,3589,969
9/3/2021,North Carolina,10042802,372,74287,3585,977
9/4/2021,North Carolina,10042802,390,74677,3532,962
9/5/2021,North Carolina,10042802,353,75030,3491,961
9/6/2021,North Carolina,10042802,344,75374,3546,960
9/7/2021,North Carolina,10042802,335,75709,3557,975
9/8/2021,North Carolina,10042802,413,76122,3579,960
9/9/2021,North Carolina,10042802,399,76521,3540,955
9/10/2021,North Carolina,10042802,367,76888,3554,964
9/11/2021,North Carolina,10042802,368,77256,3490,969
9/12/2021,North Carolina,10042802,342,77598,3391,969
9/13/2021,North Carolina,10042802,324,77922,3398,992
9/14/2021,North Carolina,10042802,388,78310,3390,988
9/15/2021,North Carolina,10042802,338,78648,3350,963
9/16/2021,North Carolina,10042802,359,79007,3382,942
9/17/2021,North Carolina,10042802,367,79374,3371,923
9/18/2021,North Carolina,10042802,301,79675,3311,917
9/19/2021,North Carolina,10042802,281,79956,3301,925
9/20/2021,North Carolina,10042802,333,80289,3301,927
9/21/2021,North Carolina,10042802,357,80646,3245,938
9/22/2021,North Carolina,10042802,331,80977,3227,914
9/23/2021,North Carolina,10042802,350,81327,3236,933
9/24/2021,North Carolina,10042802,321,81648,3154,912
9/25/2021,North Carolina,10042802,290,81938,3036,895
9/26/2021,North Carolina,10042802,267,82205,3009,916
9/27/2021,North Carolina,10042802,249,82454,2952,882
9/28/2021,North Carolina,10042802,266,82720,2888,860
9/29/2021,North Carolina,10042802,263,82983,2818,838
9/30/2021,North Carolina,10042802,270,83253,2753,811
10/1/2021,North Carolina,10042802,263,83516,2701,782
10/2/2021,North Carolina,10042802,229,83745,2641,770
10/3/2021,North Carolina,10042802,219,83964,2575,771
10/4/2021,North Carolina,10042802,240,84204,2588,768
10/5/2021,North Carolina,10042802,247,84451,2581,726
10/6/2021,North Carolina,10042802,239,84690,2539,707
10/7/2021,North Carolina,10042802,241,84931,2446,692
10/8/2021,North Carolina,10042802,222,85153,2390,683
10/9/2021,North Carolina,10042802,226,85379,2325,637
10/10/2021,North Carolina,10042802,187,85566,2341,637
10/11/2021,North Carolina,10042802,188,85754,2280,621
10/12/2021,North Carolina,10042802,229,85983,2239,629
10/13/2021,North Carolina,10042802,214,86197,2188,611
10/14/2021,North Carolina,10042802,177,86374,2086,579
10/15/2021,North Carolina,10042802,193,86567,2025,568
10/16/2021,North Carolina,10042802,193,86760,1972,568
10/17/2021,North Carolina,10042802,169,86929,1928,558
10/18/2021,North Carolina,10042802,137,87066,1899,545
10/19/2021,North Carolina,10042802,152,87218,1819,525
10/20/2021,North Carolina,10042802,143,87361,1741,506
10/21/2021,North Carolina,10042802,138,87499,1681,489
10/22/2021,North Carolina,10042802,117,87616,1610,483
10/23/2021,North Carolina,10042802,113,87729,1521,466
10/24/2021,North Carolina,10042802,103,87832,1506,444
10/25/2021,North Carolina,10042802,113,87945,1468,437
10/26/2021,North Carolina,10042802,124,88069,1434,432
10/27/2021,North Carolina,10042802,123,88192,1387,412
10/28/2021,North Carolina,10042802,111,88303,1349,410
10/29/2021,North Carolina,10042802,107,88410,1307,406
10/30/2021,North Carolina,10042802,116,88526,1234,379
10/31/2021,North Carolina,10042802,96,88622,1224,374
11/1/2021,North Carolina,10042802,94,88716,1218,380
11/2/2021,North Carolina,10042802,138,88854,1213,397
11/3/2021,North Carolina,10042802,104,88958,1168,362
11/4/2021,North Carolina,10042802,107,89065,1135,352
11/5/2021,North Carolina,10042802,105,89170,1070,325
11/6/2021,North Carolina,10042802,109,89279,1056,334
11/7/2021,North Carolina,10042802,105,89384,1067,333
11/8/2021,North Carolina,10042802,94,89478,1087,336
11/9/2021,North Carolina,10042802,126,89604,1105,324
11/10/2021,North Carolina,10042802,101,89705,1080,327
11/11/2021,North Carolina,10042802,96,89801,1090,323
11/12/2021,North Carolina,10042802,109,89910,1077,316
11/13/2021,North Carolina,10042802,101,90011,1041,306
11/14/2021,North Carolina,10042802,84,90095,1047,305
11/15/2021,North Carolina,10042802,100,90195,1057,313
11/16/2021,North Carolina,10042802,129,90324,1059,297
11/17/2021,North Carolina,10042802,108,90432,1061,298
11/18/2021,North Carolina,10042802,122,90554,1064,307
11/19/2021,North Carolina,10042802,113,90667,1061,291
11/20/2021,North Carolina,10042802,119,90786,1050,280
11/21/2021,North Carolina,10042802,113,90899,1057,291
11/22/2021,North Carolina,10042802,121,91020,1117,281
11/23/2021,North Carolina,10042802,142,91162,1110,266
11/24/2021,North Carolina,10042802,150,91312,1089,281
11/25/2021,North Carolina,10042802,117,91429,1043,276
11/26/2021,North Carolina,10042802,101,91530,1060,285
11/27/2021,North Carolina,10042802,151,91681,1085,297
11/28/2021,North Carolina,10042802,112,91793,1096,302
11/29/2021,North Carolina,10042802,117,91910,1111,292
11/30/2021,North Carolina,10042802,145,92055,1142,309
12/1/2021,North Carolina,10042802,135,92190,1192,330
12/2/2021,North Carolina,10042802,128,92318,1211,329
12/3/2021,North Carolina,10042802,169,92487,1241,346
12/4/2021,North Carolina,10042802,157,92644,1228,348
12/5/2021,North Carolina,10042802,143,92787,1288,355
12/6/2021,North Carolina,10042802,138,92925,1347,356
12/7/2021,North Carolina,10042802,189,93114,1387,373
12/8/2021,North Carolina,10042802,173,93287,1475,391
12/9/2021,North Carolina,10042802,189,93476,1475,386
12/10/2021,North Carolina,10042802,194,93670,1520,398
12/11/2021,North Carolina,10042802,188,93858,1508,421
12/12/2021,North Carolina,10042802,151,94009,1527,427
12/13/2021,North Carolina,10042802,175,94184,1552,447
12/14/2021,North Carolina,10042802,194,94378,1570,444
12/15/2021,North Carolina,10042802,189,94567,1609,436
12/16/2021,North Carolina,10042802,200,94767,1594,446
12/17/2021,North Carolina,10042802,194,94961,1613,450
12/18/2021,North Carolina,10042802,207,95168,1604,456
12/19/2021,North Carolina,10042802,191,95359,1626,458
12/20/2021,North Carolina,10042802,182,95541,1648,457
12/21/2021,North Carolina,10042802,211,95752,1656,460
12/22/2021,North Carolina,10042802,236,95988,1741,474
12/23/2021,North Carolina,10042802,244,96232,1763,456
12/24/2021,North Carolina,10042802,262,96494,1732,471
12/25/2021,North Carolina,10042802,200,96694,1723,479
12/26/2021,North Carolina,10042802,228,96922,1805,481
12/27/2021,North Carolina,10042802,248,97170,1950,503
12/28/2021,North Carolina,10042802,317,97487,2087,502
12/29/2021,North Carolina,10042802,371,97858,2257,518
12/30/2021,North Carolina,10042802,357,98215,2336,540
12/31/2021,North Carolina,10042802,347,98562,2458,560
1/1/2022,North Carolina,10042802,357,98919,2519,565
1/2/2022,North Carolina,10042802,394,99313,2647,615
1/3/2022,North Carolina,10042802,429,99742,2964,624
1/4/2022,North Carolina,10042802,467,100209,3025,649
1/5/2022,North Carolina,10042802,482,100691,3299,664
1/6/2022,North Carolina,10042802,508,101199,3445,671
1/7/2022,North Carolina,10042802,546,101745,3618,717
1/8/2022,North Carolina,10042802,523,102268,3687,718
1/9/2022,North Carolina,10042802,444,102712,3795,735
1/10/2022,North Carolina,10042802,500,103212,3946,758
1/11/2022,North Carolina,10042802,625,103837,4036,746
1/12/2022,North Carolina,10042802,598,104435,4278,779
1/13/2022,North Carolina,10042802,570,105005,4346,790
1/14/2022,North Carolina,10042802,674,105679,4445,799
1/15/2022,North Carolina,10042802,587,106266,4426,803
1/16/2022,North Carolina,10042802,550,106816,4396,784
1/17/2022,North Carolina,10042802,438,107254,4526,788
1/18/2022,North Carolina,10042802,596,107850,4647,819
1/19/2022,North Carolina,10042802,693,108543,4737,837
1/20/2022,North Carolina,10042802,683,109226,4862,845
1/21/2022,North Carolina,10042802,697,109923,4867,817
1/22/2022,North Carolina,10042802,564,110487,4832,812
1/23/2022,North Carolina,10042802,425,110912,4840,812
1/24/2022,North Carolina,10042802,584,111496,4980,834
1/25/2022,North Carolina,10042802,716,112212,5002,836
1/26/2022,North Carolina,10042802,701,112913,5175,857
1/27/2022,North Carolina,10042802,578,113491,5047,849
1/28/2022,North Carolina,10042802,643,114134,5011,831
1/29/2022,North Carolina,10042802,601,114735,4923,815
1/30/2022,North Carolina,10042802,459,115194,4840,810
1/31/2022,North Carolina,10042802,435,115629,4817,789
2/1/2022,North Carolina,10042802,545,116174,4706,777
2/2/2022,North Carolina,10042802,522,116696,4632,779
2/3/2022,North Carolina,10042802,510,117206,4503,767
2/4/2022,North Carolina,10042802,426,117632,4361,740
2/5/2022,North Carolina,10042802,434,118066,4143,714
2/6/2022,North Carolina,10042802,418,118484,4111,708
2/7/2022,North Carolina,10042802,333,118817,3916,669
2/8/2022,North Carolina,10042802,405,119222,3683,650
2/9/2022,North Carolina,10042802,405,119627,3683,650
7/1/2021,North Dakota,756927,2,5817,19,5
7/2/2021,North Dakota,756927,2,5819,18,7
7/3/2021,North Dakota,756927,0,5819,17,7
7/4/2021,North Dakota,756927,2,5821,15,6
7/5/2021,North Dakota,756927,2,5823,16,6
7/6/2021,North Dakota,756927,2,5825,18,6
7/7/2021,North Dakota,756927,1,5826,18,5
7/8/2021,North Dakota,756927,3,5829,19,4
7/9/2021,North Dakota,756927,1,5830,16,3
7/10/2021,North Dakota,756927,2,5832,16,4
7/11/2021,North Dakota,756927,2,5834,19,4
7/12/2021,North Dakota,756927,2,5836,19,4
7/13/2021,North Dakota,756927,2,5838,17,5
7/14/2021,North Dakota,756927,2,5840,17,5
7/15/2021,North Dakota,756927,3,5843,17,5
7/16/2021,North Dakota,756927,1,5844,16,5
7/17/2021,North Dakota,756927,1,5845,14,5
7/18/2021,North Dakota,756927,3,5848,16,5
7/19/2021,North Dakota,756927,4,5852,18,6
7/20/2021,North Dakota,756927,3,5855,19,6
7/21/2021,North Dakota,756927,3,5858,20,7
7/22/2021,North Dakota,756927,0,5858,17,7
7/23/2021,North Dakota,756927,5,5863,20,9
7/24/2021,North Dakota,756927,4,5867,26,9
7/25/2021,North Dakota,756927,4,5871,29,7
7/26/2021,North Dakota,756927,3,5874,26,6
7/27/2021,North Dakota,756927,2,5876,23,6
7/28/2021,North Dakota,756927,3,5879,26,7
7/29/2021,North Dakota,756927,3,5882,25,7
7/30/2021,North Dakota,756927,2,5884,23,6
7/31/2021,North Dakota,756927,3,5887,22,5
8/1/2021,North Dakota,756927,5,5892,26,6
8/2/2021,North Dakota,756927,6,5898,34,7
8/3/2021,North Dakota,756927,5,5903,34,8
8/4/2021,North Dakota,756927,1,5904,34,8
8/5/2021,North Dakota,756927,3,5907,34,7
8/6/2021,North Dakota,756927,8,5915,40,7
8/7/2021,North Dakota,756927,5,5920,41,7
8/8/2021,North Dakota,756927,7,5927,44,7
8/9/2021,North Dakota,756927,9,5936,49,7
8/10/2021,North Dakota,756927,3,5939,47,8
8/11/2021,North Dakota,756927,9,5948,55,8
8/12/2021,North Dakota,756927,9,5957,66,8
8/13/2021,North Dakota,756927,10,5967,65,10
8/14/2021,North Dakota,756927,5,5972,69,13
8/15/2021,North Dakota,756927,10,5982,69,15
8/16/2021,North Dakota,756927,13,5995,78,16
8/17/2021,North Dakota,756927,14,6009,81,15
8/18/2021,North Dakota,756927,14,6023,89,15
8/19/2021,North Dakota,756927,19,6042,93,16
8/20/2021,North Dakota,756927,15,6057,99,17
8/21/2021,North Dakota,756927,21,6078,97,17
8/22/2021,North Dakota,756927,15,6093,98,15
8/23/2021,North Dakota,756927,9,6102,103,20
8/24/2021,North Dakota,756927,16,6118,94,19
8/25/2021,North Dakota,756927,19,6137,99,19
8/26/2021,North Dakota,756927,49,6186,107,19
8/27/2021,North Dakota,756927,24,6210,117,14
8/28/2021,North Dakota,756927,26,6236,131,16
8/29/2021,North Dakota,756927,21,6257,143,23
8/30/2021,North Dakota,756927,30,6287,165,26
8/31/2021,North Dakota,756927,18,6305,159,30
9/1/2021,North Dakota,756927,19,6324,160,27
9/2/2021,North Dakota,756927,18,6342,161,29
9/3/2021,North Dakota,756927,22,6364,155,30
9/4/2021,North Dakota,756927,16,6380,134,32
9/5/2021,North Dakota,756927,14,6394,228,34
9/6/2021,North Dakota,756927,22,6416,146,34
9/7/2021,North Dakota,756927,23,6439,158,37
9/8/2021,North Dakota,756927,26,6465,167,39
9/9/2021,North Dakota,756927,26,6491,170,43
9/10/2021,North Dakota,756927,22,6513,183,40
9/11/2021,North Dakota,756927,25,6538,175,38
9/12/2021,North Dakota,756927,12,6550,165,37
9/13/2021,North Dakota,756927,20,6570,185,44
9/14/2021,North Dakota,756927,28,6598,185,53
9/15/2021,North Dakota,756927,30,6628,207,48
9/16/2021,North Dakota,756927,26,6654,197,48
9/17/2021,North Dakota,756927,25,6679,205,52
9/18/2021,North Dakota,756927,19,6698,199,47
9/19/2021,North Dakota,756927,18,6716,194,46
9/20/2021,North Dakota,756927,26,6742,191,47
9/21/2021,North Dakota,756927,33,6775,199,45
9/22/2021,North Dakota,756927,34,6809,219,57
9/23/2021,North Dakota,756927,26,6835,194,40
9/24/2021,North Dakota,756927,27,6862,198,46
9/25/2021,North Dakota,756927,36,6898,213,47
9/26/2021,North Dakota,756927,27,6925,208,52
9/27/2021,North Dakota,756927,22,6947,210,47
9/28/2021,North Dakota,756927,28,6975,219,52
9/29/2021,North Dakota,756927,44,7019,239,54
9/30/2021,North Dakota,756927,35,7054,248,57
10/1/2021,North Dakota,756927,35,7089,250,69
10/2/2021,North Dakota,756927,49,7138,255,66
10/3/2021,North Dakota,756927,23,7161,244,64
10/4/2021,North Dakota,756927,21,7182,242,61
10/5/2021,North Dakota,756927,30,7212,232,59
10/6/2021,North Dakota,756927,26,7238,228,64
10/7/2021,North Dakota,756927,25,7263,238,61
10/8/2021,North Dakota,756927,36,7299,250,57
10/9/2021,North Dakota,756927,48,7347,270,64
10/10/2021,North Dakota,756927,27,7374,267,57
10/11/2021,North Dakota,756927,27,7401,264,60
10/12/2021,North Dakota,756927,51,7452,278,65
10/13/2021,North Dakota,756927,43,7495,279,65
10/14/2021,North Dakota,756927,43,7538,272,65
10/15/2021,North Dakota,756927,35,7573,264,63
10/16/2021,North Dakota,756927,38,7611,261,59
10/17/2021,North Dakota,756927,30,7641,249,58
10/18/2021,North Dakota,756927,35,7676,248,58
10/19/2021,North Dakota,756927,26,7702,257,60
10/20/2021,North Dakota,756927,31,7733,261,64
10/21/2021,North Dakota,756927,34,7767,249,59
10/22/2021,North Dakota,756927,33,7800,224,58
10/23/2021,North Dakota,756927,30,7830,219,57
10/24/2021,North Dakota,756927,16,7846,200,54
10/25/2021,North Dakota,756927,28,7874,209,51
10/26/2021,North Dakota,756927,39,7913,233,57
10/27/2021,North Dakota,756927,32,7945,248,60
10/28/2021,North Dakota,756927,26,7971,223,58
10/29/2021,North Dakota,756927,29,8000,217,61
10/30/2021,North Dakota,756927,38,8038,220,61
10/31/2021,North Dakota,756927,22,8060,220,56
11/1/2021,North Dakota,756927,20,8080,230,58
11/2/2021,North Dakota,756927,22,8102,214,61
11/3/2021,North Dakota,756927,28,8130,227,63
11/4/2021,North Dakota,756927,32,8162,234,70
11/5/2021,North Dakota,756927,35,8197,240,72
11/6/2021,North Dakota,756927,30,8227,237,60
11/7/2021,North Dakota,756927,27,8254,232,70
11/8/2021,North Dakota,756927,14,8268,229,61
11/9/2021,North Dakota,756927,25,8293,230,64
11/10/2021,North Dakota,756927,20,8313,236,62
11/11/2021,North Dakota,756927,33,8346,250,67
11/12/2021,North Dakota,756927,26,8372,236,67
11/13/2021,North Dakota,756927,28,8400,226,67
11/14/2021,North Dakota,756927,36,8436,226,72
11/15/2021,North Dakota,756927,23,8459,244,76
11/16/2021,North Dakota,756927,24,8483,234,72
11/17/2021,North Dakota,756927,28,8511,246,71
11/18/2021,North Dakota,756927,17,8528,231,70
11/19/2021,North Dakota,756927,20,8548,229,69
11/20/2021,North Dakota,756927,34,8582,241,65
11/21/2021,North Dakota,756927,19,8601,252,68
11/22/2021,North Dakota,756927,30,8631,251,71
11/23/2021,North Dakota,756927,34,8665,264,74
11/24/2021,North Dakota,756927,31,8696,279,75
11/25/2021,North Dakota,756927,33,8729,275,75
11/26/2021,North Dakota,756927,24,8753,259,73
11/27/2021,North Dakota,756927,40,8793,256,73
11/28/2021,North Dakota,756927,26,8819,255,70
11/29/2021,North Dakota,756927,18,8837,245,70
11/30/2021,North Dakota,756927,32,8869,258,69
12/1/2021,North Dakota,756927,37,8906,258,67
12/2/2021,North Dakota,756927,26,8932,261,61
12/3/2021,North Dakota,756927,31,8963,246,64
12/4/2021,North Dakota,756927,46,9009,242,67
12/5/2021,North Dakota,756927,31,9040,232,69
12/6/2021,North Dakota,756927,20,9060,238,71
12/7/2021,North Dakota,756927,24,9084,220,67
12/8/2021,North Dakota,756927,35,9119,222,64
12/9/2021,North Dakota,756927,37,9156,244,56
12/10/2021,North Dakota,756927,26,9182,242,64
12/11/2021,North Dakota,756927,20,9202,248,69
12/12/2021,North Dakota,756927,26,9228,242,69
12/13/2021,North Dakota,756927,16,9244,244,70
12/14/2021,North Dakota,756927,23,9267,241,69
12/15/2021,North Dakota,756927,16,9283,230,69
12/16/2021,North Dakota,756927,17,9300,224,74
12/17/2021,North Dakota,756927,16,9316,211,74
12/18/2021,North Dakota,756927,15,9331,199,70
12/19/2021,North Dakota,756927,10,9341,186,67
12/20/2021,North Dakota,756927,18,9359,188,70
12/21/2021,North Dakota,756927,24,9383,188,66
12/22/2021,North Dakota,756927,24,9407,183,58
12/23/2021,North Dakota,756927,23,9430,183,59
12/24/2021,North Dakota,756927,20,9450,178,60
12/25/2021,North Dakota,756927,13,9463,172,60
12/26/2021,North Dakota,756927,9,9472,169,63
12/27/2021,North Dakota,756927,21,9493,178,60
12/28/2021,North Dakota,756927,22,9515,182,60
12/29/2021,North Dakota,756927,35,9550,191,63
12/30/2021,North Dakota,756927,20,9570,186,63
12/31/2021,North Dakota,756927,28,9598,186,58
1/1/2022,North Dakota,756927,29,9627,178,55
1/2/2022,North Dakota,756927,18,9645,181,55
1/3/2022,North Dakota,756927,17,9662,186,51
1/4/2022,North Dakota,756927,20,9682,199,53
1/5/2022,North Dakota,756927,22,9704,187,52
1/6/2022,North Dakota,756927,20,9724,188,56
1/7/2022,North Dakota,756927,26,9750,183,56
1/8/2022,North Dakota,756927,37,9787,196,55
1/9/2022,North Dakota,756927,31,9818,207,52
1/10/2022,North Dakota,756927,23,9841,208,58
1/11/2022,North Dakota,756927,26,9867,210,54
1/12/2022,North Dakota,756927,31,9898,213,50
1/13/2022,North Dakota,756927,33,9931,224,54
1/14/2022,North Dakota,756927,45,9976,237,50
1/15/2022,North Dakota,756927,52,10028,252,50
1/16/2022,North Dakota,756927,29,10057,248,50
1/17/2022,North Dakota,756927,33,10090,244,55
1/18/2022,North Dakota,756927,45,10135,258,53
1/19/2022,North Dakota,756927,32,10167,270,56
1/20/2022,North Dakota,756927,47,10214,293,55
1/21/2022,North Dakota,756927,35,10249,285,56
1/22/2022,North Dakota,756927,51,10300,289,55
1/23/2022,North Dakota,756927,45,10345,294,48
1/24/2022,North Dakota,756927,44,10389,308,49
1/25/2022,North Dakota,756927,38,10427,284,49
1/26/2022,North Dakota,756927,32,10459,299,49
1/27/2022,North Dakota,756927,52,10511,302,48
1/28/2022,North Dakota,756927,45,10556,300,57
1/29/2022,North Dakota,756927,53,10609,302,52
1/30/2022,North Dakota,756927,36,10645,304,56
1/31/2022,North Dakota,756927,41,10686,297,56
2/1/2022,North Dakota,756927,45,10731,292,50
2/2/2022,North Dakota,756927,39,10770,312,55
2/3/2022,North Dakota,756927,36,10806,314,51
2/4/2022,North Dakota,756927,29,10835,292,49
2/5/2022,North Dakota,756927,22,10857,272,48
2/6/2022,North Dakota,756927,24,10881,270,48
2/7/2022,North Dakota,756927,19,10900,227,46
2/8/2022,North Dakota,756927,36,10936,215,43
2/9/2022,North Dakota,756927,36,10972,215,43
7/1/2021,Nebraska,1896190,5,11409,46,16
7/2/2021,Nebraska,1896190,10,11419,44,15
7/3/2021,Nebraska,1896190,4,11423,50,15
7/4/2021,Nebraska,1896190,4,11427,51,16
7/5/2021,Nebraska,1896190,5,11432,57,15
7/6/2021,Nebraska,1896190,6,11438,56,13
7/7/2021,Nebraska,1896190,13,11451,58,16
7/8/2021,Nebraska,1896190,4,11455,57,14
7/9/2021,Nebraska,1896190,6,11461,60,19
7/10/2021,Nebraska,1896190,10,11471,64,21
7/11/2021,Nebraska,1896190,14,11485,74,24
7/12/2021,Nebraska,1896190,13,11498,80,22
7/13/2021,Nebraska,1896190,8,11506,78,27
7/14/2021,Nebraska,1896190,15,11521,83,26
7/15/2021,Nebraska,1896190,13,11534,91,29
7/16/2021,Nebraska,1896190,15,11549,96,27
7/17/2021,Nebraska,1896190,14,11563,104,28
7/18/2021,Nebraska,1896190,15,11578,101,31
7/19/2021,Nebraska,1896190,10,11588,100,36
7/20/2021,Nebraska,1896190,18,11606,96,35
7/21/2021,Nebraska,1896190,15,11621,92,34
7/22/2021,Nebraska,1896190,18,11639,102,36
7/23/2021,Nebraska,1896190,21,11660,113,40
7/24/2021,Nebraska,1896190,12,11672,111,42
7/25/2021,Nebraska,1896190,17,11689,111,39
7/26/2021,Nebraska,1896190,12,11701,113,45
7/27/2021,Nebraska,1896190,24,11725,124,52
7/28/2021,Nebraska,1896190,13,11738,123,54
7/29/2021,Nebraska,1896190,21,11759,144,60
7/30/2021,Nebraska,1896190,26,11785,158,60
7/31/2021,Nebraska,1896190,21,11806,148,57
8/1/2021,Nebraska,1896190,13,11819,155,60
8/2/2021,Nebraska,1896190,17,11836,164,58
8/3/2021,Nebraska,1896190,20,11856,158,51
8/4/2021,Nebraska,1896190,18,11874,154,51
8/5/2021,Nebraska,1896190,27,11901,163,49
8/6/2021,Nebraska,1896190,31,11932,176,56
8/7/2021,Nebraska,1896190,27,11959,179,58
8/8/2021,Nebraska,1896190,18,11977,187,54
8/9/2021,Nebraska,1896190,34,12011,211,62
8/10/2021,Nebraska,1896190,26,12037,217,61
8/11/2021,Nebraska,1896190,30,12067,221,68
8/12/2021,Nebraska,1896190,36,12103,235,74
8/13/2021,Nebraska,1896190,28,12131,249,78
8/14/2021,Nebraska,1896190,27,12158,259,80
8/15/2021,Nebraska,1896190,29,12187,261,73
8/16/2021,Nebraska,1896190,31,12218,278,82
8/17/2021,Nebraska,1896190,36,12254,282,91
8/18/2021,Nebraska,1896190,28,12282,286,92
8/19/2021,Nebraska,1896190,38,12320,298,97
8/20/2021,Nebraska,1896190,30,12350,292,112
8/21/2021,Nebraska,1896190,36,12386,285,111
8/22/2021,Nebraska,1896190,35,12421,291,100
8/23/2021,Nebraska,1896190,41,12462,311,94
8/24/2021,Nebraska,1896190,40,12502,314,92
8/25/2021,Nebraska,1896190,47,12549,339,90
8/26/2021,Nebraska,1896190,43,12592,330,92
8/27/2021,Nebraska,1896190,46,12638,323,88
8/28/2021,Nebraska,1896190,45,12683,316,92
8/29/2021,Nebraska,1896190,33,12716,325,94
8/30/2021,Nebraska,1896190,29,12745,329,100
8/31/2021,Nebraska,1896190,52,12797,343,116
9/1/2021,Nebraska,1896190,53,12850,374,115
9/2/2021,Nebraska,1896190,55,12905,360,114
9/3/2021,Nebraska,1896190,44,12949,364,105
9/4/2021,Nebraska,1896190,41,12990,377,100
9/5/2021,Nebraska,1896190,32,13022,368,96
9/6/2021,Nebraska,1896190,36,13058,374,102
9/7/2021,Nebraska,1896190,58,13116,379,108
9/8/2021,Nebraska,1896190,46,13162,367,104
9/9/2021,Nebraska,1896190,29,13191,351,99
9/10/2021,Nebraska,1896190,45,13236,365,104
9/11/2021,Nebraska,1896190,43,13279,381,102
9/12/2021,Nebraska,1896190,46,13325,380,101
9/13/2021,Nebraska,1896190,53,13378,396,112
9/14/2021,Nebraska,1896190,61,13439,416,125
9/15/2021,Nebraska,1896190,49,13488,414,113
9/16/2021,Nebraska,1896190,44,13532,412,126
9/17/2021,Nebraska,1896190,54,13586,416,126
9/18/2021,Nebraska,1896190,56,13642,414,125
9/19/2021,Nebraska,1896190,53,13695,421,122
9/20/2021,Nebraska,1896190,65,13760,448,126
9/21/2021,Nebraska,1896190,59,13819,433,119
9/22/2021,Nebraska,1896190,48,13867,431,128
9/23/2021,Nebraska,1896190,34,13901,404,127
9/24/2021,Nebraska,1896190,53,13954,409,131
9/25/2021,Nebraska,1896190,44,13998,392,125
9/26/2021,Nebraska,1896190,46,14044,392,125
9/27/2021,Nebraska,1896190,50,14094,431,130
9/28/2021,Nebraska,1896190,65,14159,426,139
9/29/2021,Nebraska,1896190,35,14194,423,141
9/30/2021,Nebraska,1896190,44,14238,415,131
10/1/2021,Nebraska,1896190,56,14294,431,124
10/2/2021,Nebraska,1896190,33,14327,413,120
10/3/2021,Nebraska,1896190,44,14371,404,112
10/4/2021,Nebraska,1896190,38,14409,410,119
10/5/2021,Nebraska,1896190,52,14461,413,123
10/6/2021,Nebraska,1896190,56,14517,422,126
10/7/2021,Nebraska,1896190,41,14558,408,127
10/8/2021,Nebraska,1896190,36,14594,400,113
10/9/2021,Nebraska,1896190,48,14642,391,118
10/10/2021,Nebraska,1896190,51,14693,399,120
10/11/2021,Nebraska,1896190,49,14742,413,120
10/12/2021,Nebraska,1896190,52,14794,410,111
10/13/2021,Nebraska,1896190,45,14839,406,120
10/14/2021,Nebraska,1896190,44,14883,385,118
10/15/2021,Nebraska,1896190,50,14933,382,114
10/16/2021,Nebraska,1896190,45,14978,379,123
10/17/2021,Nebraska,1896190,38,15016,375,119
10/18/2021,Nebraska,1896190,44,15060,379,108
10/19/2021,Nebraska,1896190,45,15105,366,120
10/20/2021,Nebraska,1896190,42,15147,365,121
10/21/2021,Nebraska,1896190,33,15180,361,129
10/22/2021,Nebraska,1896190,37,15217,375,134
10/23/2021,Nebraska,1896190,49,15266,360,129
10/24/2021,Nebraska,1896190,40,15306,362,119
10/25/2021,Nebraska,1896190,46,15352,390,121
10/26/2021,Nebraska,1896190,43,15395,378,131
10/27/2021,Nebraska,1896190,45,15440,355,118
10/28/2021,Nebraska,1896190,66,15506,390,124
10/29/2021,Nebraska,1896190,70,15576,474,142
10/30/2021,Nebraska,1896190,67,15643,408,125
10/31/2021,Nebraska,1896190,41,15684,409,128
11/1/2021,Nebraska,1896190,57,15741,408,125
11/2/2021,Nebraska,1896190,56,15797,415,139
11/3/2021,Nebraska,1896190,45,15842,408,136
11/4/2021,Nebraska,1896190,63,15905,421,135
11/5/2021,Nebraska,1896190,51,15956,424,135
11/6/2021,Nebraska,1896190,44,16000,416,127
11/7/2021,Nebraska,1896190,41,16041,410,122
11/8/2021,Nebraska,1896190,41,16082,420,132
11/9/2021,Nebraska,1896190,42,16124,408,135
11/10/2021,Nebraska,1896190,54,16178,418,132
11/11/2021,Nebraska,1896190,63,16241,440,130
11/12/2021,Nebraska,1896190,51,16292,436,126
11/13/2021,Nebraska,1896190,65,16357,451,129
11/14/2021,Nebraska,1896190,61,16418,451,120
11/15/2021,Nebraska,1896190,61,16479,462,119
11/16/2021,Nebraska,1896190,63,16542,465,119
11/17/2021,Nebraska,1896190,74,16616,462,123
11/18/2021,Nebraska,1896190,80,16696,455,127
11/19/2021,Nebraska,1896190,63,16759,491,146
11/20/2021,Nebraska,1896190,64,16823,501,148
11/21/2021,Nebraska,1896190,54,16877,478,154
11/22/2021,Nebraska,1896190,69,16946,510,156
11/23/2021,Nebraska,1896190,77,17023,515,165
11/24/2021,Nebraska,1896190,54,17077,515,158
11/25/2021,Nebraska,1896190,73,17150,490,162
11/26/2021,Nebraska,1896190,51,17201,498,159
11/27/2021,Nebraska,1896190,58,17259,513,165
11/28/2021,Nebraska,1896190,53,17312,524,174
11/29/2021,Nebraska,1896190,71,17383,548,171
11/30/2021,Nebraska,1896190,71,17454,557,175
12/1/2021,Nebraska,1896190,62,17516,541,161
12/2/2021,Nebraska,1896190,66,17582,552,169
12/3/2021,Nebraska,1896190,87,17669,539,161
12/4/2021,Nebraska,1896190,72,17741,539,171
12/5/2021,Nebraska,1896190,62,17803,572,178
12/6/2021,Nebraska,1896190,46,17849,579,173
12/7/2021,Nebraska,1896190,64,17913,576,171
12/8/2021,Nebraska,1896190,67,17980,602,168
12/9/2021,Nebraska,1896190,71,18051,614,161
12/10/2021,Nebraska,1896190,68,18119,612,173
12/11/2021,Nebraska,1896190,65,18184,597,170
12/12/2021,Nebraska,1896190,61,18245,608,174
12/13/2021,Nebraska,1896190,63,18308,638,179
12/14/2021,Nebraska,1896190,63,18371,623,184
12/15/2021,Nebraska,1896190,60,18431,609,161
12/16/2021,Nebraska,1896190,53,18484,589,156
12/17/2021,Nebraska,1896190,51,18535,556,151
12/18/2021,Nebraska,1896190,46,18581,528,136
12/19/2021,Nebraska,1896190,50,18631,507,138
12/20/2021,Nebraska,1896190,48,18679,517,153
12/21/2021,Nebraska,1896190,49,18728,496,153
12/22/2021,Nebraska,1896190,52,18780,494,154
12/23/2021,Nebraska,1896190,51,18831,481,155
12/24/2021,Nebraska,1896190,38,18869,449,156
12/25/2021,Nebraska,1896190,42,18911,450,161
12/26/2021,Nebraska,1896190,40,18951,452,163
12/27/2021,Nebraska,1896190,43,18994,472,150
12/28/2021,Nebraska,1896190,57,19051,498,147
12/29/2021,Nebraska,1896190,67,19118,508,149
12/30/2021,Nebraska,1896190,43,19161,491,149
12/31/2021,Nebraska,1896190,76,19237,508,144
1/1/2022,Nebraska,1896190,51,19288,508,142
1/2/2022,Nebraska,1896190,41,19329,520,144
1/3/2022,Nebraska,1896190,64,19393,535,139
1/4/2022,Nebraska,1896190,52,19445,532,144
1/5/2022,Nebraska,1896190,72,19517,563,146
1/6/2022,Nebraska,1896190,52,19569,568,134
1/7/2022,Nebraska,1896190,62,19631,567,140
1/8/2022,Nebraska,1896190,94,19725,614,154
1/9/2022,Nebraska,1896190,62,19787,615,151
1/10/2022,Nebraska,1896190,64,19851,632,140
1/11/2022,Nebraska,1896190,86,19937,654,147
1/12/2022,Nebraska,1896190,83,20020,661,150
1/13/2022,Nebraska,1896190,69,20089,671,156
1/14/2022,Nebraska,1896190,77,20166,680,178
1/15/2022,Nebraska,1896190,61,20227,651,172
1/16/2022,Nebraska,1896190,56,20283,640,156
1/17/2022,Nebraska,1896190,79,20362,668,158
1/18/2022,Nebraska,1896190,114,20476,706,167
1/19/2022,Nebraska,1896190,105,20581,728,165
1/20/2022,Nebraska,1896190,99,20680,740,167
1/21/2022,Nebraska,1896190,93,20773,752,153
1/22/2022,Nebraska,1896190,71,20844,715,156
1/23/2022,Nebraska,1896190,66,20910,720,138
1/24/2022,Nebraska,1896190,77,20987,750,143
1/25/2022,Nebraska,1896190,100,21087,746,142
1/26/2022,Nebraska,1896190,97,21184,741,147
1/27/2022,Nebraska,1896190,87,21271,758,153
1/28/2022,Nebraska,1896190,107,21378,765,142
1/29/2022,Nebraska,1896190,75,21453,732,143
1/30/2022,Nebraska,1896190,56,21509,735,148
1/31/2022,Nebraska,1896190,83,21592,741,156
2/1/2022,Nebraska,1896190,108,21700,735,155
2/2/2022,Nebraska,1896190,101,21801,738,152
2/3/2022,Nebraska,1896190,67,21868,672,146
2/4/2022,Nebraska,1896190,66,21934,658,137
2/5/2022,Nebraska,1896190,55,21989,604,123
2/6/2022,Nebraska,1896190,53,22042,600,126
2/7/2022,Nebraska,1896190,46,22088,586,112
2/8/2022,Nebraska,1896190,70,22158,584,111
2/9/2022,Nebraska,1896190,70,22228,584,111
7/1/2021,New Hampshire,1330608,2,4934,12,2
7/2/2021,New Hampshire,1330608,0,4934,11,1
7/3/2021,New Hampshire,1330608,3,4937,14,2
7/4/2021,New Hampshire,1330608,2,4939,17,2
7/5/2021,New Hampshire,1330608,1,4940,11,3
7/6/2021,New Hampshire,1330608,1,4941,12,4
7/7/2021,New Hampshire,1330608,3,4944,17,4
7/8/2021,New Hampshire,1330608,4,4948,16,5
7/9/2021,New Hampshire,1330608,6,4954,18,6
7/10/2021,New Hampshire,1330608,3,4957,19,5
7/11/2021,New Hampshire,1330608,4,4961,15,4
7/12/2021,New Hampshire,1330608,2,4963,14,4
7/13/2021,New Hampshire,1330608,1,4964,11,3
7/14/2021,New Hampshire,1330608,2,4966,12,3
7/15/2021,New Hampshire,1330608,5,4971,20,4
7/16/2021,New Hampshire,1330608,1,4972,14,4
7/17/2021,New Hampshire,1330608,4,4976,17,6
7/18/2021,New Hampshire,1330608,2,4978,19,6
7/19/2021,New Hampshire,1330608,6,4984,23,6
7/20/2021,New Hampshire,1330608,6,4990,22,8
7/21/2021,New Hampshire,1330608,7,4997,25,11
7/22/2021,New Hampshire,1330608,5,5002,24,10
7/23/2021,New Hampshire,1330608,3,5005,21,8
7/24/2021,New Hampshire,1330608,2,5007,21,8
7/25/2021,New Hampshire,1330608,4,5011,23,9
7/26/2021,New Hampshire,1330608,1,5012,20,8
7/27/2021,New Hampshire,1330608,2,5014,20,7
7/28/2021,New Hampshire,1330608,3,5017,24,8
7/29/2021,New Hampshire,1330608,9,5026,31,8
7/30/2021,New Hampshire,1330608,3,5029,29,8
7/31/2021,New Hampshire,1330608,6,5035,31,8
8/1/2021,New Hampshire,1330608,3,5038,34,9
8/2/2021,New Hampshire,1330608,6,5044,35,9
8/3/2021,New Hampshire,1330608,4,5048,34,10
8/4/2021,New Hampshire,1330608,3,5051,30,10
8/5/2021,New Hampshire,1330608,6,5057,34,8
8/6/2021,New Hampshire,1330608,7,5064,39,12
8/7/2021,New Hampshire,1330608,9,5073,44,12
8/8/2021,New Hampshire,1330608,11,5084,43,14
8/9/2021,New Hampshire,1330608,7,5091,48,16
8/10/2021,New Hampshire,1330608,6,5097,45,18
8/11/2021,New Hampshire,1330608,16,5113,57,19
8/12/2021,New Hampshire,1330608,15,5128,63,19
8/13/2021,New Hampshire,1330608,8,5136,58,17
8/14/2021,New Hampshire,1330608,8,5144,72,18
8/15/2021,New Hampshire,1330608,10,5154,71,18
8/16/2021,New Hampshire,1330608,15,5169,68,25
8/17/2021,New Hampshire,1330608,14,5183,72,27
8/18/2021,New Hampshire,1330608,13,5196,75,28
8/19/2021,New Hampshire,1330608,11,5207,81,28
8/20/2021,New Hampshire,1330608,13,5220,89,31
8/21/2021,New Hampshire,1330608,27,5247,99,33
8/22/2021,New Hampshire,1330608,26,5273,104,30
8/23/2021,New Hampshire,1330608,35,5308,109,28
8/24/2021,New Hampshire,1330608,16,5324,104,31
8/25/2021,New Hampshire,1330608,24,5348,104,31
8/26/2021,New Hampshire,1330608,23,5371,108,27
8/27/2021,New Hampshire,1330608,21,5392,109,32
8/28/2021,New Hampshire,1330608,10,5402,96,32
8/29/2021,New Hampshire,1330608,14,5416,104,37
8/30/2021,New Hampshire,1330608,18,5434,109,43
8/31/2021,New Hampshire,1330608,18,5452,105,40
9/1/2021,New Hampshire,1330608,22,5474,109,36
9/2/2021,New Hampshire,1330608,26,5500,125,35
9/3/2021,New Hampshire,1330608,12,5512,119,33
9/4/2021,New Hampshire,1330608,22,5534,121,33
9/5/2021,New Hampshire,1330608,29,5563,132,36
9/6/2021,New Hampshire,1330608,18,5581,135,38
9/7/2021,New Hampshire,1330608,13,5594,134,37
9/8/2021,New Hampshire,1330608,25,5619,131,35
9/9/2021,New Hampshire,1330608,26,5645,135,36
9/10/2021,New Hampshire,1330608,12,5657,139,37
9/11/2021,New Hampshire,1330608,14,5671,147,41
9/12/2021,New Hampshire,1330608,16,5687,142,43
9/13/2021,New Hampshire,1330608,19,5706,136,38
9/14/2021,New Hampshire,1330608,16,5722,123,34
9/15/2021,New Hampshire,1330608,18,5740,123,30
9/16/2021,New Hampshire,1330608,12,5752,114,25
9/17/2021,New Hampshire,1330608,11,5763,115,29
9/18/2021,New Hampshire,1330608,17,5780,126,32
9/19/2021,New Hampshire,1330608,14,5794,126,30
9/20/2021,New Hampshire,1330608,14,5808,130,31
9/21/2021,New Hampshire,1330608,19,5827,128,32
9/22/2021,New Hampshire,1330608,21,5848,136,40
9/23/2021,New Hampshire,1330608,26,5874,138,36
9/24/2021,New Hampshire,1330608,19,5893,138,32
9/25/2021,New Hampshire,1330608,13,5906,138,31
9/26/2021,New Hampshire,1330608,14,5920,137,30
9/27/2021,New Hampshire,1330608,17,5937,138,36
9/28/2021,New Hampshire,1330608,23,5960,142,42
9/29/2021,New Hampshire,1330608,22,5982,137,40
9/30/2021,New Hampshire,1330608,17,5999,141,45
10/1/2021,New Hampshire,1330608,21,6020,135,45
10/2/2021,New Hampshire,1330608,21,6041,128,46
10/3/2021,New Hampshire,1330608,12,6053,123,45
10/4/2021,New Hampshire,1330608,10,6063,120,42
10/5/2021,New Hampshire,1330608,21,6084,125,45
10/6/2021,New Hampshire,1330608,13,6097,122,45
10/7/2021,New Hampshire,1330608,13,6110,120,48
10/8/2021,New Hampshire,1330608,19,6129,126,43
10/9/2021,New Hampshire,1330608,27,6156,136,46
10/10/2021,New Hampshire,1330608,13,6169,139,49
10/11/2021,New Hampshire,1330608,17,6186,130,44
10/12/2021,New Hampshire,1330608,18,6204,132,47
10/13/2021,New Hampshire,1330608,16,6220,134,47
10/14/2021,New Hampshire,1330608,17,6237,138,46
10/15/2021,New Hampshire,1330608,22,6259,154,47
10/16/2021,New Hampshire,1330608,36,6295,160,43
10/17/2021,New Hampshire,1330608,29,6324,170,46
10/18/2021,New Hampshire,1330608,23,6347,191,47
10/19/2021,New Hampshire,1330608,23,6370,188,51
10/20/2021,New Hampshire,1330608,35,6405,199,52
10/21/2021,New Hampshire,1330608,28,6433,207,46
10/22/2021,New Hampshire,1330608,23,6456,203,46
10/23/2021,New Hampshire,1330608,26,6482,214,41
10/24/2021,New Hampshire,1330608,17,6499,204,44
10/25/2021,New Hampshire,1330608,20,6519,204,49
10/26/2021,New Hampshire,1330608,16,6535,187,45
10/27/2021,New Hampshire,1330608,25,6560,189,40
10/28/2021,New Hampshire,1330608,35,6595,180,35
10/29/2021,New Hampshire,1330608,28,6623,193,37
10/30/2021,New Hampshire,1330608,25,6648,180,37
10/31/2021,New Hampshire,1330608,28,6676,186,41
11/1/2021,New Hampshire,1330608,18,6694,182,40
11/2/2021,New Hampshire,1330608,24,6718,182,34
11/3/2021,New Hampshire,1330608,26,6744,190,41
11/4/2021,New Hampshire,1330608,30,6774,191,42
11/5/2021,New Hampshire,1330608,39,6813,206,43
11/6/2021,New Hampshire,1330608,32,6845,212,44
11/7/2021,New Hampshire,1330608,28,6873,210,46
11/8/2021,New Hampshire,1330608,25,6898,212,52
11/9/2021,New Hampshire,1330608,37,6935,229,44
11/10/2021,New Hampshire,1330608,40,6975,228,48
11/11/2021,New Hampshire,1330608,37,7012,245,47
11/12/2021,New Hampshire,1330608,29,7041,240,41
11/13/2021,New Hampshire,1330608,39,7080,250,49
11/14/2021,New Hampshire,1330608,28,7108,259,48
11/15/2021,New Hampshire,1330608,23,7131,279,49
11/16/2021,New Hampshire,1330608,36,7167,305,52
11/17/2021,New Hampshire,1330608,44,7211,304,47
11/18/2021,New Hampshire,1330608,35,7246,305,52
11/19/2021,New Hampshire,1330608,47,7293,324,59
11/20/2021,New Hampshire,1330608,41,7334,304,50
11/21/2021,New Hampshire,1330608,43,7377,313,55
11/22/2021,New Hampshire,1330608,42,7419,328,60
11/23/2021,New Hampshire,1330608,46,7465,345,57
11/24/2021,New Hampshire,1330608,43,7508,341,67
11/25/2021,New Hampshire,1330608,44,7552,347,75
11/26/2021,New Hampshire,1330608,45,7597,364,76
11/27/2021,New Hampshire,1330608,52,7649,341,81
11/28/2021,New Hampshire,1330608,39,7688,361,85
11/29/2021,New Hampshire,1330608,53,7741,381,86
11/30/2021,New Hampshire,1330608,57,7798,389,90
12/1/2021,New Hampshire,1330608,47,7845,387,89
12/2/2021,New Hampshire,1330608,61,7906,385,90
12/3/2021,New Hampshire,1330608,58,7964,376,88
12/4/2021,New Hampshire,1330608,54,8018,391,85
12/5/2021,New Hampshire,1330608,54,8072,427,94
12/6/2021,New Hampshire,1330608,46,8118,424,102
12/7/2021,New Hampshire,1330608,64,8182,438,105
12/8/2021,New Hampshire,1330608,66,8248,450,102
12/9/2021,New Hampshire,1330608,65,8313,453,100
12/10/2021,New Hampshire,1330608,53,8366,435,98
12/11/2021,New Hampshire,1330608,57,8423,454,103
12/12/2021,New Hampshire,1330608,57,8480,446,109
12/13/2021,New Hampshire,1330608,49,8529,454,104
12/14/2021,New Hampshire,1330608,61,8590,466,109
12/15/2021,New Hampshire,1330608,39,8629,454,109
12/16/2021,New Hampshire,1330608,48,8677,447,112
12/17/2021,New Hampshire,1330608,59,8736,458,110
12/18/2021,New Hampshire,1330608,47,8783,445,113
12/19/2021,New Hampshire,1330608,36,8819,432,115
12/20/2021,New Hampshire,1330608,46,8865,441,119
12/21/2021,New Hampshire,1330608,44,8909,418,110
12/22/2021,New Hampshire,1330608,38,8947,370,100
12/23/2021,New Hampshire,1330608,62,9009,403,113
12/24/2021,New Hampshire,1330608,43,9052,394,109
12/25/2021,New Hampshire,1330608,39,9091,401,108
12/26/2021,New Hampshire,1330608,37,9128,391,101
12/27/2021,New Hampshire,1330608,39,9167,401,95
12/28/2021,New Hampshire,1330608,49,9216,405,102
12/29/2021,New Hampshire,1330608,49,9265,402,97
12/30/2021,New Hampshire,1330608,45,9310,381,91
12/31/2021,New Hampshire,1330608,39,9349,362,90
1/1/2022,New Hampshire,1330608,53,9402,357,88
1/2/2022,New Hampshire,1330608,38,9440,380,87
1/3/2022,New Hampshire,1330608,32,9472,365,85
1/4/2022,New Hampshire,1330608,53,9525,370,85
1/5/2022,New Hampshire,1330608,47,9572,365,79
1/6/2022,New Hampshire,1330608,54,9626,372,76
1/7/2022,New Hampshire,1330608,44,9670,390,72
1/8/2022,New Hampshire,1330608,54,9724,383,71
1/9/2022,New Hampshire,1330608,39,9763,381,77
1/10/2022,New Hampshire,1330608,58,9821,383,78
1/11/2022,New Hampshire,1330608,71,9892,402,79
1/12/2022,New Hampshire,1330608,69,9961,431,80
1/13/2022,New Hampshire,1330608,47,10008,431,80
1/14/2022,New Hampshire,1330608,75,10083,441,77
1/15/2022,New Hampshire,1330608,67,10150,420,78
1/16/2022,New Hampshire,1330608,47,10197,428,78
1/17/2022,New Hampshire,1330608,55,10252,410,79
1/18/2022,New Hampshire,1330608,67,10319,415,72
1/19/2022,New Hampshire,1330608,58,10377,423,73
1/20/2022,New Hampshire,1330608,60,10437,392,71
1/21/2022,New Hampshire,1330608,60,10497,413,64
1/22/2022,New Hampshire,1330608,55,10552,392,61
1/23/2022,New Hampshire,1330608,70,10622,415,62
1/24/2022,New Hampshire,1330608,55,10677,401,63
1/25/2022,New Hampshire,1330608,56,10733,397,59
1/26/2022,New Hampshire,1330608,47,10780,388,52
1/27/2022,New Hampshire,1330608,48,10828,384,48
1/28/2022,New Hampshire,1330608,37,10865,344,49
1/29/2022,New Hampshire,1330608,48,10913,322,50
1/30/2022,New Hampshire,1330608,31,10944,308,45
1/31/2022,New Hampshire,1330608,39,10983,310,45
2/1/2022,New Hampshire,1330608,52,11035,306,47
2/2/2022,New Hampshire,1330608,34,11069,288,44
2/3/2022,New Hampshire,1330608,35,11104,262,47
2/4/2022,New Hampshire,1330608,34,11138,222,42
2/5/2022,New Hampshire,1330608,37,11175,221,36
2/6/2022,New Hampshire,1330608,42,11217,211,31
2/7/2022,New Hampshire,1330608,16,11233,193,26
2/8/2022,New Hampshire,1330608,40,11273,188,25
2/9/2022,New Hampshire,1330608,40,11313,188,25
7/1/2021,New Jersey,8958013,35,65164,243,42
7/2/2021,New Jersey,8958013,24,65188,230,35
7/3/2021,New Jersey,8958013,28,65216,230,42
7/4/2021,New Jersey,8958013,33,65249,232,42
7/5/2021,New Jersey,8958013,27,65276,222,39
7/6/2021,New Jersey,8958013,32,65308,244,41
7/7/2021,New Jersey,8958013,46,65354,253,42
7/8/2021,New Jersey,8958013,40,65394,271,48
7/9/2021,New Jersey,8958013,31,65425,282,50
7/10/2021,New Jersey,8958013,36,65461,264,49
7/11/2021,New Jersey,8958013,30,65491,270,49
7/12/2021,New Jersey,8958013,27,65518,265,47
7/13/2021,New Jersey,8958013,43,65561,265,42
7/14/2021,New Jersey,8958013,36,65597,255,43
7/15/2021,New Jersey,8958013,41,65638,258,40
7/16/2021,New Jersey,8958013,40,65678,257,42
7/17/2021,New Jersey,8958013,51,65729,274,41
7/18/2021,New Jersey,8958013,45,65774,281,45
7/19/2021,New Jersey,8958013,44,65818,303,46
7/20/2021,New Jersey,8958013,50,65868,317,52
7/21/2021,New Jersey,8958013,43,65911,310,55
7/22/2021,New Jersey,8958013,49,65960,334,57
7/23/2021,New Jersey,8958013,49,66009,330,57
7/24/2021,New Jersey,8958013,75,66084,359,58
7/25/2021,New Jersey,8958013,59,66143,364,65
7/26/2021,New Jersey,8958013,56,66199,372,62
7/27/2021,New Jersey,8958013,70,66269,403,70
7/28/2021,New Jersey,8958013,60,66329,412,57
7/29/2021,New Jersey,8958013,67,66396,419,63
7/30/2021,New Jersey,8958013,68,66464,437,66
7/31/2021,New Jersey,8958013,80,66544,416,73
8/1/2021,New Jersey,8958013,93,66637,469,77
8/2/2021,New Jersey,8958013,98,66735,514,82
8/3/2021,New Jersey,8958013,90,66825,535,78
8/4/2021,New Jersey,8958013,90,66915,518,74
8/5/2021,New Jersey,8958013,77,66992,552,87
8/6/2021,New Jersey,8958013,100,67092,572,87
8/7/2021,New Jersey,8958013,81,67173,584,90
8/8/2021,New Jersey,8958013,81,67254,588,103
8/9/2021,New Jersey,8958013,96,67350,615,112
8/10/2021,New Jersey,8958013,108,67458,641,124
8/11/2021,New Jersey,8958013,118,67576,685,118
8/12/2021,New Jersey,8958013,121,67697,701,126
8/13/2021,New Jersey,8958013,130,67827,721,126
8/14/2021,New Jersey,8958013,124,67951,738,129
8/15/2021,New Jersey,8958013,127,68078,797,135
8/16/2021,New Jersey,8958013,117,68195,810,144
8/17/2021,New Jersey,8958013,132,68327,806,149
8/18/2021,New Jersey,8958013,144,68471,844,156
8/19/2021,New Jersey,8958013,137,68608,847,158
8/20/2021,New Jersey,8958013,138,68746,867,157
8/21/2021,New Jersey,8958013,163,68909,874,156
8/22/2021,New Jersey,8958013,157,69066,896,155
8/23/2021,New Jersey,8958013,125,69191,944,161
8/24/2021,New Jersey,8958013,159,69350,979,167
8/25/2021,New Jersey,8958013,126,69476,966,170
8/26/2021,New Jersey,8958013,159,69635,987,178
8/27/2021,New Jersey,8958013,140,69775,961,178
8/28/2021,New Jersey,8958013,139,69914,978,189
8/29/2021,New Jersey,8958013,114,70028,993,191
8/30/2021,New Jersey,8958013,123,70151,1023,195
8/31/2021,New Jersey,8958013,167,70318,1035,185
9/1/2021,New Jersey,8958013,150,70468,1022,192
9/2/2021,New Jersey,8958013,153,70621,1020,196
9/3/2021,New Jersey,8958013,141,70762,1024,200
9/4/2021,New Jersey,8958013,152,70914,985,195
9/5/2021,New Jersey,8958013,135,71049,994,205
9/6/2021,New Jersey,8958013,145,71194,1064,229
9/7/2021,New Jersey,8958013,160,71354,1115,228
9/8/2021,New Jersey,8958013,145,71499,1133,233
9/9/2021,New Jersey,8958013,144,71643,1116,237
9/10/2021,New Jersey,8958013,160,71803,1081,211
9/11/2021,New Jersey,8958013,159,71962,1055,211
9/12/2021,New Jersey,8958013,119,72081,1056,217
9/13/2021,New Jersey,8958013,145,72226,1075,211
9/14/2021,New Jersey,8958013,165,72391,1092,232
9/15/2021,New Jersey,8958013,147,72538,1083,228
9/16/2021,New Jersey,8958013,143,72681,1074,221
9/17/2021,New Jersey,8958013,148,72829,1076,230
9/18/2021,New Jersey,8958013,135,72964,1057,236
9/19/2021,New Jersey,8958013,127,73091,1065,225
9/20/2021,New Jersey,8958013,116,73207,1090,225
9/21/2021,New Jersey,8958013,153,73360,1101,234
9/22/2021,New Jersey,8958013,133,73493,1069,223
9/23/2021,New Jersey,8958013,137,73630,1050,215
9/24/2021,New Jersey,8958013,118,73748,1033,211
9/25/2021,New Jersey,8958013,122,73870,998,212
9/26/2021,New Jersey,8958013,113,73983,990,214
9/27/2021,New Jersey,8958013,114,74097,1027,207
9/28/2021,New Jersey,8958013,122,74219,1022,210
9/29/2021,New Jersey,8958013,133,74352,1015,207
9/30/2021,New Jersey,8958013,132,74484,995,211
10/1/2021,New Jersey,8958013,154,74638,999,208
10/2/2021,New Jersey,8958013,142,74780,1000,215
10/3/2021,New Jersey,8958013,102,74882,1025,217
10/4/2021,New Jersey,8958013,116,74998,1024,217
10/5/2021,New Jersey,8958013,119,75117,989,207
10/6/2021,New Jersey,8958013,117,75234,942,212
10/7/2021,New Jersey,8958013,125,75359,939,215
10/8/2021,New Jersey,8958013,94,75453,910,202
10/9/2021,New Jersey,8958013,103,75556,849,193
10/10/2021,New Jersey,8958013,78,75634,841,193
10/11/2021,New Jersey,8958013,102,75736,877,193
10/12/2021,New Jersey,8958013,115,75851,851,190
10/13/2021,New Jersey,8958013,106,75957,799,179
10/14/2021,New Jersey,8958013,118,76075,865,187
10/15/2021,New Jersey,8958013,109,76184,858,192
10/16/2021,New Jersey,8958013,103,76287,854,173
10/17/2021,New Jersey,8958013,87,76374,849,183
10/18/2021,New Jersey,8958013,89,76463,857,186
10/19/2021,New Jersey,8958013,103,76566,840,197
10/20/2021,New Jersey,8958013,97,76663,825,186
10/21/2021,New Jersey,8958013,99,76762,813,194
10/22/2021,New Jersey,8958013,113,76875,797,195
10/23/2021,New Jersey,8958013,97,76972,774,201
10/24/2021,New Jersey,8958013,86,77058,761,199
10/25/2021,New Jersey,8958013,59,77117,772,188
10/26/2021,New Jersey,8958013,90,77207,755,169
10/27/2021,New Jersey,8958013,88,77295,728,165
10/28/2021,New Jersey,8958013,89,77384,717,166
10/29/2021,New Jersey,8958013,88,77472,689,164
10/30/2021,New Jersey,8958013,83,77555,675,154
10/31/2021,New Jersey,8958013,69,77624,678,149
11/1/2021,New Jersey,8958013,72,77696,663,146
11/2/2021,New Jersey,8958013,89,77785,638,141
11/3/2021,New Jersey,8958013,69,77854,622,150
11/4/2021,New Jersey,8958013,69,77923,617,149
11/5/2021,New Jersey,8958013,70,77993,627,150
11/6/2021,New Jersey,8958013,92,78085,623,140
11/7/2021,New Jersey,8958013,71,78156,615,131
11/8/2021,New Jersey,8958013,75,78231,635,126
11/9/2021,New Jersey,8958013,91,78322,629,108
11/10/2021,New Jersey,8958013,105,78427,651,101
11/11/2021,New Jersey,8958013,101,78528,657,120
11/12/2021,New Jersey,8958013,73,78601,645,128
11/13/2021,New Jersey,8958013,80,78681,634,123
11/14/2021,New Jersey,8958013,97,78778,644,113
11/15/2021,New Jersey,8958013,86,78864,692,129
11/16/2021,New Jersey,8958013,135,78999,722,134
11/17/2021,New Jersey,8958013,105,79104,722,142
11/18/2021,New Jersey,8958013,114,79218,732,148
11/19/2021,New Jersey,8958013,117,79335,764,154
11/20/2021,New Jersey,8958013,107,79442,734,151
11/21/2021,New Jersey,8958013,107,79549,785,147
11/22/2021,New Jersey,8958013,109,79658,818,157
11/23/2021,New Jersey,8958013,140,79798,840,154
11/24/2021,New Jersey,8958013,116,79914,824,139
11/25/2021,New Jersey,8958013,116,80030,815,139
11/26/2021,New Jersey,8958013,125,80155,845,148
11/27/2021,New Jersey,8958013,137,80292,857,153
11/28/2021,New Jersey,8958013,146,80438,918,161
11/29/2021,New Jersey,8958013,159,80597,1002,169
11/30/2021,New Jersey,8958013,175,80772,1017,192
12/1/2021,New Jersey,8958013,164,80936,992,189
12/2/2021,New Jersey,8958013,152,81088,1021,152
12/3/2021,New Jersey,8958013,187,81275,1088,194
12/4/2021,New Jersey,8958013,191,81466,1125,195
12/5/2021,New Jersey,8958013,179,81645,1195,220
12/6/2021,New Jersey,8958013,175,81820,1264,222
12/7/2021,New Jersey,8958013,259,82079,1354,243
12/8/2021,New Jersey,8958013,226,82305,1407,239
12/9/2021,New Jersey,8958013,266,82571,1497,250
12/10/2021,New Jersey,8958013,264,82835,1510,258
12/11/2021,New Jersey,8958013,245,83080,1528,266
12/12/2021,New Jersey,8958013,230,83310,1594,281
12/13/2021,New Jersey,8958013,224,83534,1663,298
12/14/2021,New Jersey,8958013,246,83780,1692,305
12/15/2021,New Jersey,8958013,273,84053,1727,311
12/16/2021,New Jersey,8958013,255,84308,1722,317
12/17/2021,New Jersey,8958013,285,84593,1774,306
12/18/2021,New Jersey,8958013,293,84886,1801,322
12/19/2021,New Jersey,8958013,259,85145,1864,325
12/20/2021,New Jersey,8958013,273,85418,1974,348
12/21/2021,New Jersey,8958013,323,85741,2034,360
12/22/2021,New Jersey,8958013,430,86171,2171,377
12/23/2021,New Jersey,8958013,413,86584,2291,392
12/24/2021,New Jersey,8958013,409,86993,2343,386
12/25/2021,New Jersey,8958013,405,87398,2429,397
12/26/2021,New Jersey,8958013,429,87827,2650,412
12/27/2021,New Jersey,8958013,510,88337,2896,443
12/28/2021,New Jersey,8958013,672,89009,3223,463
12/29/2021,New Jersey,8958013,702,89711,3589,502
12/30/2021,New Jersey,8958013,753,90464,3834,546
12/31/2021,New Jersey,8958013,772,91236,4042,546
1/1/2022,New Jersey,8958013,773,92009,4283,542
1/2/2022,New Jersey,8958013,855,92864,4738,608
1/3/2022,New Jersey,8958013,826,93690,5064,649
1/4/2022,New Jersey,8958013,911,94601,5352,663
1/5/2022,New Jersey,8958013,951,95552,5589,660
1/6/2022,New Jersey,8958013,947,96499,5722,689
1/7/2022,New Jersey,8958013,955,97454,5842,739
1/8/2022,New Jersey,8958013,919,98373,5909,783
1/9/2022,New Jersey,8958013,787,99160,5957,789
1/10/2022,New Jersey,8958013,759,99919,5986,803
1/11/2022,New Jersey,8958013,931,100850,6021,845
1/12/2022,New Jersey,8958013,848,101698,6138,838
1/13/2022,New Jersey,8958013,797,102495,6079,842
1/14/2022,New Jersey,8958013,808,103303,5928,818
1/15/2022,New Jersey,8958013,712,104015,5640,825
1/16/2022,New Jersey,8958013,565,104580,5567,821
1/17/2022,New Jersey,8958013,501,105081,5328,793
1/18/2022,New Jersey,8958013,658,105739,5214,763
1/19/2022,New Jersey,8958013,694,106433,5183,737
1/20/2022,New Jersey,8958013,590,107023,5011,730
1/21/2022,New Jersey,8958013,543,107566,4658,689
1/22/2022,New Jersey,8958013,500,108066,4390,689
1/23/2022,New Jersey,8958013,398,108464,4287,659
1/24/2022,New Jersey,8958013,404,108868,4078,650
1/25/2022,New Jersey,8958013,492,109360,3889,624
1/26/2022,New Jersey,8958013,455,109815,3753,596
1/27/2022,New Jersey,8958013,415,110230,3595,557
1/28/2022,New Jersey,8958013,368,110598,3405,531
1/29/2022,New Jersey,8958013,309,110907,3039,493
1/30/2022,New Jersey,8958013,207,111114,3042,478
1/31/2022,New Jersey,8958013,235,111349,2934,472
2/1/2022,New Jersey,8958013,290,111639,2776,420
2/2/2022,New Jersey,8958013,260,111899,2546,396
2/3/2022,New Jersey,8958013,246,112145,2452,390
2/4/2022,New Jersey,8958013,236,112381,2304,378
2/5/2022,New Jersey,8958013,213,112594,2106,352
2/6/2022,New Jersey,8958013,153,112747,1995,344
2/7/2022,New Jersey,8958013,150,112897,1954,341
2/8/2022,New Jersey,8958013,186,113083,1810,318
2/9/2022,New Jersey,8958013,186,113269,1810,318
7/1/2021,New Mexico,2085109,11,15956,70,30
7/2/2021,New Mexico,2085109,10,15966,71,28
7/3/2021,New Mexico,2085109,14,15980,72,26
7/4/2021,New Mexico,2085109,11,15991,69,25
7/5/2021,New Mexico,2085109,8,15999,68,21
7/6/2021,New Mexico,2085109,21,16020,73,24
7/7/2021,New Mexico,2085109,9,16029,70,25
7/8/2021,New Mexico,2085109,20,16049,78,29
7/9/2021,New Mexico,2085109,20,16069,79,25
7/10/2021,New Mexico,2085109,17,16086,85,28
7/11/2021,New Mexico,2085109,9,16095,90,29
7/12/2021,New Mexico,2085109,8,16103,89,32
7/13/2021,New Mexico,2085109,18,16121,100,32
7/14/2021,New Mexico,2085109,13,16134,99,29
7/15/2021,New Mexico,2085109,13,16147,96,31
7/16/2021,New Mexico,2085109,13,16160,93,33
7/17/2021,New Mexico,2085109,14,16174,86,36
7/18/2021,New Mexico,2085109,20,16194,89,37
7/19/2021,New Mexico,2085109,16,16210,100,38
7/20/2021,New Mexico,2085109,20,16230,102,43
7/21/2021,New Mexico,2085109,14,16244,101,41
7/22/2021,New Mexico,2085109,23,16267,109,42
7/23/2021,New Mexico,2085109,24,16291,110,40
7/24/2021,New Mexico,2085109,18,16309,115,48
7/25/2021,New Mexico,2085109,18,16327,107,53
7/26/2021,New Mexico,2085109,25,16352,122,52
7/27/2021,New Mexico,2085109,24,16376,140,59
7/28/2021,New Mexico,2085109,33,16409,149,58
7/29/2021,New Mexico,2085109,21,16430,151,63
7/30/2021,New Mexico,2085109,22,16452,163,66
7/31/2021,New Mexico,2085109,24,16476,170,75
8/1/2021,New Mexico,2085109,33,16509,180,73
8/2/2021,New Mexico,2085109,28,16537,188,77
8/3/2021,New Mexico,2085109,31,16568,197,81
8/4/2021,New Mexico,2085109,29,16597,207,86
8/5/2021,New Mexico,2085109,43,16640,221,82
8/6/2021,New Mexico,2085109,29,16669,228,87
8/7/2021,New Mexico,2085109,39,16708,241,87
8/8/2021,New Mexico,2085109,40,16748,242,88
8/9/2021,New Mexico,2085109,39,16787,258,90
8/10/2021,New Mexico,2085109,37,16824,264,89
8/11/2021,New Mexico,2085109,54,16878,305,106
8/12/2021,New Mexico,2085109,37,16915,306,117
8/13/2021,New Mexico,2085109,55,16970,325,123
8/14/2021,New Mexico,2085109,47,17017,351,123
8/15/2021,New Mexico,2085109,49,17066,336,121
8/16/2021,New Mexico,2085109,55,17121,357,132
8/17/2021,New Mexico,2085109,65,17186,368,135
8/18/2021,New Mexico,2085109,56,17242,382,129
8/19/2021,New Mexico,2085109,52,17294,409,138
8/20/2021,New Mexico,2085109,48,17342,394,135
8/21/2021,New Mexico,2085109,58,17400,424,136
8/22/2021,New Mexico,2085109,55,17455,429,142
8/23/2021,New Mexico,2085109,69,17524,456,147
8/24/2021,New Mexico,2085109,63,17587,466,152
8/25/2021,New Mexico,2085109,58,17645,465,154
8/26/2021,New Mexico,2085109,57,17702,448,159
8/27/2021,New Mexico,2085109,85,17787,451,159
8/28/2021,New Mexico,2085109,64,17851,445,147
8/29/2021,New Mexico,2085109,57,17908,447,152
8/30/2021,New Mexico,2085109,64,17972,448,155
8/31/2021,New Mexico,2085109,61,18033,426,147
9/1/2021,New Mexico,2085109,69,18102,436,153
9/2/2021,New Mexico,2085109,73,18175,450,165
9/3/2021,New Mexico,2085109,63,18238,440,165
9/4/2021,New Mexico,2085109,72,18310,456,172
9/5/2021,New Mexico,2085109,66,18376,460,176
9/6/2021,New Mexico,2085109,48,18424,454,165
9/7/2021,New Mexico,2085109,44,18468,443,165
9/8/2021,New Mexico,2085109,54,18522,427,175
9/9/2021,New Mexico,2085109,57,18579,400,164
9/10/2021,New Mexico,2085109,62,18641,461,179
9/11/2021,New Mexico,2085109,55,18696,429,164
9/12/2021,New Mexico,2085109,59,18755,425,153
9/13/2021,New Mexico,2085109,52,18807,399,149
9/14/2021,New Mexico,2085109,62,18869,417,140
9/15/2021,New Mexico,2085109,62,18931,396,136
9/16/2021,New Mexico,2085109,55,18986,389,132
9/17/2021,New Mexico,2085109,51,19037,387,128
9/18/2021,New Mexico,2085109,57,19094,408,132
9/19/2021,New Mexico,2085109,34,19128,388,138
9/20/2021,New Mexico,2085109,44,19172,378,135
9/21/2021,New Mexico,2085109,55,19227,367,143
9/22/2021,New Mexico,2085109,41,19268,361,139
9/23/2021,New Mexico,2085109,43,19311,347,129
9/24/2021,New Mexico,2085109,45,19356,329,124
9/25/2021,New Mexico,2085109,50,19406,329,132
9/26/2021,New Mexico,2085109,33,19439,325,121
9/27/2021,New Mexico,2085109,44,19483,335,118
9/28/2021,New Mexico,2085109,39,19522,313,121
9/29/2021,New Mexico,2085109,59,19581,346,120
9/30/2021,New Mexico,2085109,56,19637,386,132
10/1/2021,New Mexico,2085109,56,19693,399,123
10/2/2021,New Mexico,2085109,57,19750,383,131
10/3/2021,New Mexico,2085109,30,19780,381,131
10/4/2021,New Mexico,2085109,41,19821,377,125
10/5/2021,New Mexico,2085109,49,19870,369,120
10/6/2021,New Mexico,2085109,80,19950,365,128
10/7/2021,New Mexico,2085109,69,20019,378,143
10/8/2021,New Mexico,2085109,53,20072,373,123
10/9/2021,New Mexico,2085109,36,20108,340,111
10/10/2021,New Mexico,2085109,36,20144,342,110
10/11/2021,New Mexico,2085109,35,20179,335,107
10/12/2021,New Mexico,2085109,58,20237,356,104
10/13/2021,New Mexico,2085109,55,20292,374,104
10/14/2021,New Mexico,2085109,53,20345,369,101
10/15/2021,New Mexico,2085109,67,20412,385,107
10/16/2021,New Mexico,2085109,41,20453,362,103
10/17/2021,New Mexico,2085109,35,20488,365,105
10/18/2021,New Mexico,2085109,47,20535,381,115
10/19/2021,New Mexico,2085109,63,20598,373,120
10/20/2021,New Mexico,2085109,59,20657,396,125
10/21/2021,New Mexico,2085109,42,20699,389,124
10/22/2021,New Mexico,2085109,77,20776,373,123
10/23/2021,New Mexico,2085109,69,20845,402,122
10/24/2021,New Mexico,2085109,72,20917,411,120
10/25/2021,New Mexico,2085109,50,20967,407,128
10/26/2021,New Mexico,2085109,82,21049,423,133
10/27/2021,New Mexico,2085109,73,21122,435,166
10/28/2021,New Mexico,2085109,64,21186,437,154
10/29/2021,New Mexico,2085109,67,21253,460,144
10/30/2021,New Mexico,2085109,65,21318,441,137
10/31/2021,New Mexico,2085109,64,21382,456,148
11/1/2021,New Mexico,2085109,63,21445,445,145
11/2/2021,New Mexico,2085109,68,21513,481,143
11/3/2021,New Mexico,2085109,70,21583,498,136
11/4/2021,New Mexico,2085109,68,21651,498,132
11/5/2021,New Mexico,2085109,61,21712,489,136
11/6/2021,New Mexico,2085109,68,21780,495,142
11/7/2021,New Mexico,2085109,62,21842,523,145
11/8/2021,New Mexico,2085109,61,21903,528,145
11/9/2021,New Mexico,2085109,98,22001,553,161
11/10/2021,New Mexico,2085109,69,22070,565,154
11/11/2021,New Mexico,2085109,68,22138,589,157
11/12/2021,New Mexico,2085109,70,22208,601,159
11/13/2021,New Mexico,2085109,65,22273,578,156
11/14/2021,New Mexico,2085109,70,22343,604,166
11/15/2021,New Mexico,2085109,71,22414,615,159
11/16/2021,New Mexico,2085109,83,22497,605,163
11/17/2021,New Mexico,2085109,66,22563,616,172
11/18/2021,New Mexico,2085109,78,22641,612,166
11/19/2021,New Mexico,2085109,77,22718,610,179
11/20/2021,New Mexico,2085109,82,22800,645,181
11/21/2021,New Mexico,2085109,81,22881,654,186
11/22/2021,New Mexico,2085109,84,22965,679,196
11/23/2021,New Mexico,2085109,71,23036,688,207
11/24/2021,New Mexico,2085109,70,23106,661,195
11/25/2021,New Mexico,2085109,61,23167,645,188
11/26/2021,New Mexico,2085109,61,23228,664,200
11/27/2021,New Mexico,2085109,63,23291,660,197
11/28/2021,New Mexico,2085109,62,23353,666,194
11/29/2021,New Mexico,2085109,88,23441,682,212
11/30/2021,New Mexico,2085109,75,23516,692,211
12/1/2021,New Mexico,2085109,95,23611,709,208
12/2/2021,New Mexico,2085109,82,23693,734,192
12/3/2021,New Mexico,2085109,60,23753,719,198
12/4/2021,New Mexico,2085109,74,23827,717,204
12/5/2021,New Mexico,2085109,78,23905,725,211
12/6/2021,New Mexico,2085109,61,23966,732,207
12/7/2021,New Mexico,2085109,87,24053,734,209
12/8/2021,New Mexico,2085109,98,24151,766,205
12/9/2021,New Mexico,2085109,79,24230,762,216
12/10/2021,New Mexico,2085109,72,24302,750,224
12/11/2021,New Mexico,2085109,76,24378,730,227
12/12/2021,New Mexico,2085109,60,24438,728,226
12/13/2021,New Mexico,2085109,74,24512,744,215
12/14/2021,New Mexico,2085109,56,24568,711,211
12/15/2021,New Mexico,2085109,77,24645,730,214
12/16/2021,New Mexico,2085109,60,24705,677,202
12/17/2021,New Mexico,2085109,48,24753,661,195
12/18/2021,New Mexico,2085109,66,24819,639,190
12/19/2021,New Mexico,2085109,52,24871,645,200
12/20/2021,New Mexico,2085109,56,24927,614,176
12/21/2021,New Mexico,2085109,63,24990,605,167
12/22/2021,New Mexico,2085109,60,25050,614,167
12/23/2021,New Mexico,2085109,75,25125,610,194
12/24/2021,New Mexico,2085109,64,25189,615,191
12/25/2021,New Mexico,2085109,51,25240,566,179
12/26/2021,New Mexico,2085109,46,25286,549,176
12/27/2021,New Mexico,2085109,51,25337,539,169
12/28/2021,New Mexico,2085109,60,25397,529,160
12/29/2021,New Mexico,2085109,61,25458,541,182
12/30/2021,New Mexico,2085109,72,25530,535,173
12/31/2021,New Mexico,2085109,69,25599,521,156
1/1/2022,New Mexico,2085109,67,25666,541,157
1/2/2022,New Mexico,2085109,49,25715,550,151
1/3/2022,New Mexico,2085109,75,25790,560,149
1/4/2022,New Mexico,2085109,71,25861,556,154
1/5/2022,New Mexico,2085109,78,25939,581,164
1/6/2022,New Mexico,2085109,79,26018,606,166
1/7/2022,New Mexico,2085109,70,26088,587,175
1/8/2022,New Mexico,2085109,82,26170,599,162
1/9/2022,New Mexico,2085109,77,26247,613,153
1/10/2022,New Mexico,2085109,75,26322,652,152
1/11/2022,New Mexico,2085109,85,26407,651,151
1/12/2022,New Mexico,2085109,84,26491,655,149
1/13/2022,New Mexico,2085109,101,26592,672,155
1/14/2022,New Mexico,2085109,86,26678,648,147
1/15/2022,New Mexico,2085109,106,26784,679,158
1/16/2022,New Mexico,2085109,83,26867,677,146
1/17/2022,New Mexico,2085109,85,26952,706,145
1/18/2022,New Mexico,2085109,108,27060,721,152
1/19/2022,New Mexico,2085109,119,27179,756,161
1/20/2022,New Mexico,2085109,118,27297,750,167
1/21/2022,New Mexico,2085109,111,27408,736,153
1/22/2022,New Mexico,2085109,113,27521,738,160
1/23/2022,New Mexico,2085109,111,27632,773,157
1/24/2022,New Mexico,2085109,92,27724,810,159
1/25/2022,New Mexico,2085109,103,27827,792,156
1/26/2022,New Mexico,2085109,95,27922,769,153
1/27/2022,New Mexico,2085109,124,28046,781,162
1/28/2022,New Mexico,2085109,93,28139,768,148
1/29/2022,New Mexico,2085109,86,28225,680,157
1/30/2022,New Mexico,2085109,94,28319,690,143
1/31/2022,New Mexico,2085109,92,28411,702,152
2/1/2022,New Mexico,2085109,91,28502,715,142
2/2/2022,New Mexico,2085109,136,28638,726,151
2/3/2022,New Mexico,2085109,103,28741,721,159
2/4/2022,New Mexico,2085109,76,28817,710,150
2/5/2022,New Mexico,2085109,85,28902,678,146
2/6/2022,New Mexico,2085109,70,28972,620,137
2/7/2022,New Mexico,2085109,90,29062,640,143
2/8/2022,New Mexico,2085109,67,29129,623,142
2/9/2022,New Mexico,2085109,67,29196,623,142
7/1/2021,Nevada,2890845,75,25770,411,93
7/2/2021,Nevada,2890845,83,25853,448,95
7/3/2021,Nevada,2890845,68,25921,449,131
7/4/2021,Nevada,2890845,72,25993,479,105
7/5/2021,Nevada,2890845,67,26060,486,112
7/6/2021,Nevada,2890845,81,26141,538,115
7/7/2021,Nevada,2890845,86,26227,589,123
7/8/2021,Nevada,2890845,91,26318,621,134
7/9/2021,Nevada,2890845,86,26404,638,133
7/10/2021,Nevada,2890845,81,26485,616,140
7/11/2021,Nevada,2890845,90,26575,677,146
7/12/2021,Nevada,2890845,101,26676,729,163
7/13/2021,Nevada,2890845,94,26770,743,168
7/14/2021,Nevada,2890845,103,26873,757,152
7/15/2021,Nevada,2890845,99,26972,787,175
7/16/2021,Nevada,2890845,103,27075,800,182
7/17/2021,Nevada,2890845,125,27200,861,187
7/18/2021,Nevada,2890845,74,27274,874,203
7/19/2021,Nevada,2890845,104,27378,900,207
7/20/2021,Nevada,2890845,112,27490,951,214
7/21/2021,Nevada,2890845,128,27618,954,203
7/22/2021,Nevada,2890845,134,27752,968,210
7/23/2021,Nevada,2890845,110,27862,1008,220
7/24/2021,Nevada,2890845,95,27957,998,214
7/25/2021,Nevada,2890845,136,28093,1023,218
7/26/2021,Nevada,2890845,147,28240,1065,230
7/27/2021,Nevada,2890845,134,28374,1096,239
7/28/2021,Nevada,2890845,128,28502,1100,254
7/29/2021,Nevada,2890845,133,28635,1105,245
7/30/2021,Nevada,2890845,137,28772,1110,253
7/31/2021,Nevada,2890845,134,28906,1120,260
8/1/2021,Nevada,2890845,131,29037,1168,264
8/2/2021,Nevada,2890845,107,29144,1186,261
8/3/2021,Nevada,2890845,117,29261,1174,267
8/4/2021,Nevada,2890845,137,29398,1166,273
8/5/2021,Nevada,2890845,131,29529,1224,286
8/6/2021,Nevada,2890845,152,29681,1204,282
8/7/2021,Nevada,2890845,134,29815,1187,278
8/8/2021,Nevada,2890845,127,29942,1206,287
8/9/2021,Nevada,2890845,133,30075,1226,289
8/10/2021,Nevada,2890845,160,30235,1272,300
8/11/2021,Nevada,2890845,160,30395,1271,294
8/12/2021,Nevada,2890845,146,30541,1262,298
8/13/2021,Nevada,2890845,146,30687,1272,307
8/14/2021,Nevada,2890845,140,30827,1269,296
8/15/2021,Nevada,2890845,126,30953,1248,298
8/16/2021,Nevada,2890845,117,31070,1272,307
8/17/2021,Nevada,2890845,132,31202,1225,309
8/18/2021,Nevada,2890845,154,31356,1236,299
8/19/2021,Nevada,2890845,140,31496,1228,292
8/20/2021,Nevada,2890845,136,31632,1240,294
8/21/2021,Nevada,2890845,125,31757,1196,284
8/22/2021,Nevada,2890845,138,31895,1249,280
8/23/2021,Nevada,2890845,123,32018,1248,299
8/24/2021,Nevada,2890845,145,32163,1265,305
8/25/2021,Nevada,2890845,132,32295,1265,294
8/26/2021,Nevada,2890845,132,32427,1218,283
8/27/2021,Nevada,2890845,146,32573,1222,286
8/28/2021,Nevada,2890845,108,32681,1175,272
8/29/2021,Nevada,2890845,112,32793,1153,285
8/30/2021,Nevada,2890845,104,32897,1151,280
8/31/2021,Nevada,2890845,132,33029,1156,277
9/1/2021,Nevada,2890845,132,33161,1155,292
9/2/2021,Nevada,2890845,117,33278,1110,295
9/3/2021,Nevada,2890845,96,33374,1129,288
9/4/2021,Nevada,2890845,128,33502,1147,288
9/5/2021,Nevada,2890845,115,33617,1167,287
9/6/2021,Nevada,2890845,121,33738,1141,278
9/7/2021,Nevada,2890845,114,33852,1156,287
9/8/2021,Nevada,2890845,120,33972,1120,280
9/9/2021,Nevada,2890845,130,34102,1116,288
9/10/2021,Nevada,2890845,103,34205,1101,285
9/11/2021,Nevada,2890845,101,34306,1086,269
9/12/2021,Nevada,2890845,96,34402,1081,258
9/13/2021,Nevada,2890845,106,34508,1059,254
9/14/2021,Nevada,2890845,143,34651,1051,251
9/15/2021,Nevada,2890845,101,34752,1027,240
9/16/2021,Nevada,2890845,133,34885,1021,244
9/17/2021,Nevada,2890845,110,34995,1010,249
9/18/2021,Nevada,2890845,92,35087,961,240
9/19/2021,Nevada,2890845,113,35200,989,242
9/20/2021,Nevada,2890845,106,35306,988,241
9/21/2021,Nevada,2890845,88,35394,961,215
9/22/2021,Nevada,2890845,95,35489,950,211
9/23/2021,Nevada,2890845,96,35585,939,218
9/24/2021,Nevada,2890845,93,35678,913,216
9/25/2021,Nevada,2890845,80,35758,875,224
9/26/2021,Nevada,2890845,83,35841,902,211
9/27/2021,Nevada,2890845,60,35901,890,220
9/28/2021,Nevada,2890845,89,35990,879,229
9/29/2021,Nevada,2890845,103,36093,891,219
9/30/2021,Nevada,2890845,94,36187,889,213
10/1/2021,Nevada,2890845,88,36275,861,216
10/2/2021,Nevada,2890845,91,36366,829,208
10/3/2021,Nevada,2890845,85,36451,831,190
10/4/2021,Nevada,2890845,89,36540,827,192
10/5/2021,Nevada,2890845,99,36639,843,194
10/6/2021,Nevada,2890845,105,36744,818,195
10/7/2021,Nevada,2890845,70,36814,797,194
10/8/2021,Nevada,2890845,79,36893,768,189
10/9/2021,Nevada,2890845,88,36981,748,186
10/10/2021,Nevada,2890845,65,37046,738,181
10/11/2021,Nevada,2890845,56,37102,708,173
10/12/2021,Nevada,2890845,78,37180,693,170
10/13/2021,Nevada,2890845,77,37257,708,169
10/14/2021,Nevada,2890845,74,37331,700,162
10/15/2021,Nevada,2890845,77,37408,694,161
10/16/2021,Nevada,2890845,80,37488,669,157
10/17/2021,Nevada,2890845,80,37568,684,151
10/18/2021,Nevada,2890845,76,37644,678,155
10/19/2021,Nevada,2890845,77,37721,659,173
10/20/2021,Nevada,2890845,59,37780,609,164
10/21/2021,Nevada,2890845,68,37848,621,170
10/22/2021,Nevada,2890845,68,37916,619,176
10/23/2021,Nevada,2890845,72,37988,627,175
10/24/2021,Nevada,2890845,60,38048,604,169
10/25/2021,Nevada,2890845,61,38109,612,169
10/26/2021,Nevada,2890845,76,38185,626,163
10/27/2021,Nevada,2890845,67,38252,616,163
10/28/2021,Nevada,2890845,71,38323,609,149
10/29/2021,Nevada,2890845,68,38391,604,158
10/30/2021,Nevada,2890845,69,38460,609,159
10/31/2021,Nevada,2890845,74,38534,632,167
11/1/2021,Nevada,2890845,81,38615,649,181
11/2/2021,Nevada,2890845,69,38684,656,175
11/3/2021,Nevada,2890845,97,38781,680,179
11/4/2021,Nevada,2890845,68,38849,674,176
11/5/2021,Nevada,2890845,68,38917,674,177
11/6/2021,Nevada,2890845,78,38995,673,162
11/7/2021,Nevada,2890845,72,39067,663,155
11/8/2021,Nevada,2890845,56,39123,658,155
11/9/2021,Nevada,2890845,71,39194,663,153
11/10/2021,Nevada,2890845,102,39296,681,157
11/11/2021,Nevada,2890845,82,39378,696,166
11/12/2021,Nevada,2890845,69,39447,687,166
11/13/2021,Nevada,2890845,62,39509,652,155
11/14/2021,Nevada,2890845,67,39576,683,166
11/15/2021,Nevada,2890845,61,39637,662,147
11/16/2021,Nevada,2890845,62,39699,656,148
11/17/2021,Nevada,2890845,77,39776,644,147
11/18/2021,Nevada,2890845,71,39847,680,160
11/19/2021,Nevada,2890845,74,39921,646,155
11/20/2021,Nevada,2890845,61,39982,644,156
11/21/2021,Nevada,2890845,61,40043,646,157
11/22/2021,Nevada,2890845,62,40105,691,166
11/23/2021,Nevada,2890845,74,40179,683,169
11/24/2021,Nevada,2890845,84,40263,676,170
11/25/2021,Nevada,2890845,63,40326,647,162
11/26/2021,Nevada,2890845,64,40390,647,169
11/27/2021,Nevada,2890845,73,40463,635,160
11/28/2021,Nevada,2890845,68,40531,631,152
11/29/2021,Nevada,2890845,72,40603,639,159
11/30/2021,Nevada,2890845,78,40681,657,157
12/1/2021,Nevada,2890845,70,40751,643,152
12/2/2021,Nevada,2890845,64,40815,622,160
12/3/2021,Nevada,2890845,76,40891,628,152
12/4/2021,Nevada,2890845,77,40968,617,148
12/5/2021,Nevada,2890845,56,41024,620,154
12/6/2021,Nevada,2890845,60,41084,636,148
12/7/2021,Nevada,2890845,82,41166,637,155
12/8/2021,Nevada,2890845,98,41264,653,151
12/9/2021,Nevada,2890845,90,41354,666,156
12/10/2021,Nevada,2890845,66,41420,655,159
12/11/2021,Nevada,2890845,60,41480,657,162
12/12/2021,Nevada,2890845,62,41542,652,162
12/13/2021,Nevada,2890845,67,41609,667,164
12/14/2021,Nevada,2890845,73,41682,656,168
12/15/2021,Nevada,2890845,75,41757,644,166
12/16/2021,Nevada,2890845,71,41828,638,165
12/17/2021,Nevada,2890845,72,41900,626,168
12/18/2021,Nevada,2890845,84,41984,653,173
12/19/2021,Nevada,2890845,78,42062,627,170
12/20/2021,Nevada,2890845,85,42147,655,159
12/21/2021,Nevada,2890845,79,42226,636,146
12/22/2021,Nevada,2890845,71,42297,621,156
12/23/2021,Nevada,2890845,94,42391,639,156
12/24/2021,Nevada,2890845,99,42490,648,150
12/25/2021,Nevada,2890845,74,42564,655,153
12/26/2021,Nevada,2890845,89,42653,704,152
12/27/2021,Nevada,2890845,87,42740,727,162
12/28/2021,Nevada,2890845,96,42836,770,170
12/29/2021,Nevada,2890845,122,42958,800,176
12/30/2021,Nevada,2890845,121,43079,827,161
12/31/2021,Nevada,2890845,129,43208,860,163
1/1/2022,Nevada,2890845,148,43356,869,166
1/2/2022,Nevada,2890845,159,43515,948,178
1/3/2022,Nevada,2890845,128,43643,1002,175
1/4/2022,Nevada,2890845,163,43806,1088,178
1/5/2022,Nevada,2890845,189,43995,1189,181
1/6/2022,Nevada,2890845,164,44159,1250,207
1/7/2022,Nevada,2890845,222,44381,1359,218
1/8/2022,Nevada,2890845,238,44619,1432,230
1/9/2022,Nevada,2890845,185,44804,1455,230
1/10/2022,Nevada,2890845,203,45007,1544,254
1/11/2022,Nevada,2890845,264,45271,1608,251
1/12/2022,Nevada,2890845,201,45472,1616,244
1/13/2022,Nevada,2890845,238,45710,1707,270
1/14/2022,Nevada,2890845,230,45940,1795,291
1/15/2022,Nevada,2890845,270,46210,1858,313
1/16/2022,Nevada,2890845,189,46399,1854,307
1/17/2022,Nevada,2890845,187,46586,1948,307
1/18/2022,Nevada,2890845,238,46824,1883,310
1/19/2022,Nevada,2890845,248,47072,1981,306
1/20/2022,Nevada,2890845,239,47311,2012,317
1/21/2022,Nevada,2890845,227,47538,2006,326
1/22/2022,Nevada,2890845,211,47749,1960,329
1/23/2022,Nevada,2890845,205,47954,1993,325
1/24/2022,Nevada,2890845,193,48147,2024,340
1/25/2022,Nevada,2890845,224,48371,1977,351
1/26/2022,Nevada,2890845,211,48582,1923,342
1/27/2022,Nevada,2890845,187,48769,1853,330
1/28/2022,Nevada,2890845,164,48933,1792,308
1/29/2022,Nevada,2890845,182,49115,1746,319
1/30/2022,Nevada,2890845,159,49274,1711,322
1/31/2022,Nevada,2890845,143,49417,1697,311
2/1/2022,Nevada,2890845,165,49582,1590,313
2/2/2022,Nevada,2890845,171,49753,1549,291
2/3/2022,Nevada,2890845,138,49891,1480,280
2/4/2022,Nevada,2890845,131,50022,1391,272
2/5/2022,Nevada,2890845,150,50172,1351,248
2/6/2022,Nevada,2890845,103,50275,1245,230
2/7/2022,Nevada,2890845,98,50373,1231,232
2/8/2022,Nevada,2890845,94,50467,1172,216
2/9/2022,Nevada,2890845,94,50561,1172,216
7/1/2021,New York,19795791,51,138977,398,99
7/2/2021,New York,19795791,55,139032,390,94
7/3/2021,New York,19795791,58,139090,382,101
7/4/2021,New York,19795791,46,139136,368,95
7/5/2021,New York,19795791,57,139193,381,96
7/6/2021,New York,19795791,61,139254,396,95
7/7/2021,New York,19795791,66,139320,385,97
7/8/2021,New York,19795791,49,139369,374,91
7/9/2021,New York,19795791,51,139420,376,88
7/10/2021,New York,19795791,52,139472,376,92
7/11/2021,New York,19795791,48,139520,380,97
7/12/2021,New York,19795791,57,139577,391,100
7/13/2021,New York,19795791,54,139631,386,95
7/14/2021,New York,19795791,58,139689,382,99
7/15/2021,New York,19795791,88,139777,397,97
7/16/2021,New York,19795791,76,139853,396,90
7/17/2021,New York,19795791,64,139917,394,93
7/18/2021,New York,19795791,71,139988,414,98
7/19/2021,New York,19795791,71,140059,456,110
7/20/2021,New York,19795791,93,140152,497,122
7/21/2021,New York,19795791,99,140251,512,125
7/22/2021,New York,19795791,113,140364,542,128
7/23/2021,New York,19795791,77,140441,540,133
7/24/2021,New York,19795791,98,140539,552,137
7/25/2021,New York,19795791,85,140624,593,128
7/26/2021,New York,19795791,95,140719,629,124
7/27/2021,New York,19795791,108,140827,647,125
7/28/2021,New York,19795791,121,140948,668,130
7/29/2021,New York,19795791,134,141082,702,126
7/30/2021,New York,19795791,132,141214,753,142
7/31/2021,New York,19795791,136,141350,774,158
8/1/2021,New York,19795791,123,141473,831,169
8/2/2021,New York,19795791,138,141611,894,176
8/3/2021,New York,19795791,161,141772,944,195
8/4/2021,New York,19795791,210,141982,1036,199
8/5/2021,New York,19795791,210,142192,1082,217
8/6/2021,New York,19795791,201,142393,1149,238
8/7/2021,New York,19795791,244,142637,1204,242
8/8/2021,New York,19795791,189,142826,1278,254
8/9/2021,New York,19795791,242,143068,1375,274
8/10/2021,New York,19795791,227,143295,1408,302
8/11/2021,New York,19795791,285,143580,1505,309
8/12/2021,New York,19795791,301,143881,1594,320
8/13/2021,New York,19795791,316,144197,1694,348
8/14/2021,New York,19795791,301,144498,1709,350
8/15/2021,New York,19795791,238,144736,1757,366
8/16/2021,New York,19795791,251,144987,1801,379
8/17/2021,New York,19795791,333,145320,1912,393
8/18/2021,New York,19795791,326,145646,1983,400
8/19/2021,New York,19795791,291,145937,1978,406
8/20/2021,New York,19795791,307,146244,1866,388
8/21/2021,New York,19795791,264,146508,1870,398
8/22/2021,New York,19795791,264,146772,2055,422
8/23/2021,New York,19795791,251,147023,2138,428
8/24/2021,New York,19795791,336,147359,2211,452
8/25/2021,New York,19795791,334,147693,2252,464
8/26/2021,New York,19795791,334,148027,2286,461
8/27/2021,New York,19795791,318,148345,2319,481
8/28/2021,New York,19795791,283,148628,2208,468
8/29/2021,New York,19795791,272,148900,2226,486
8/30/2021,New York,19795791,240,149140,2283,496
8/31/2021,New York,19795791,348,149488,2330,494
9/1/2021,New York,19795791,358,149846,2386,504
9/2/2021,New York,19795791,363,150209,2389,528
9/3/2021,New York,19795791,322,150531,2362,534
9/4/2021,New York,19795791,316,150847,2315,515
9/5/2021,New York,19795791,288,151135,2350,506
9/6/2021,New York,19795791,298,151433,2398,504
9/7/2021,New York,19795791,294,151727,2434,497
9/8/2021,New York,19795791,339,152066,2486,520
9/9/2021,New York,19795791,300,152366,2445,527
9/10/2021,New York,19795791,353,152719,2471,526
9/11/2021,New York,19795791,312,153031,2396,529
9/12/2021,New York,19795791,288,153319,2443,560
9/13/2021,New York,19795791,314,153633,2508,560
9/14/2021,New York,19795791,304,153937,2453,583
9/15/2021,New York,19795791,314,154251,2436,568
9/16/2021,New York,19795791,327,154578,2464,566
9/17/2021,New York,19795791,318,154896,2411,534
9/18/2021,New York,19795791,322,155218,2370,563
9/19/2021,New York,19795791,258,155476,2396,566
9/20/2021,New York,19795791,272,155748,2454,559
9/21/2021,New York,19795791,315,156063,2393,572
9/22/2021,New York,19795791,276,156339,2390,568
9/23/2021,New York,19795791,317,156656,2416,559
9/24/2021,New York,19795791,337,156993,2417,574
9/25/2021,New York,19795791,288,157281,2338,563
9/26/2021,New York,19795791,257,157538,2392,573
9/27/2021,New York,19795791,233,157771,2377,579
9/28/2021,New York,19795791,310,158081,2371,544
9/29/2021,New York,19795791,278,158359,2299,539
9/30/2021,New York,19795791,252,158611,2206,542
10/1/2021,New York,19795791,288,158899,2217,556
10/2/2021,New York,19795791,287,159186,2186,552
10/3/2021,New York,19795791,250,159436,2205,559
10/4/2021,New York,19795791,264,159700,2245,555
10/5/2021,New York,19795791,322,160022,2251,551
10/6/2021,New York,19795791,262,160284,2253,542
10/7/2021,New York,19795791,275,160559,2200,507
10/8/2021,New York,19795791,279,160838,2158,484
10/9/2021,New York,19795791,273,161111,2088,480
10/10/2021,New York,19795791,225,161336,2103,489
10/11/2021,New York,19795791,248,161584,2168,494
10/12/2021,New York,19795791,278,161862,2128,499
10/13/2021,New York,19795791,287,162149,2112,493
10/14/2021,New York,19795791,315,162464,2174,499
10/15/2021,New York,19795791,302,162766,2158,498
10/16/2021,New York,19795791,287,163053,2119,481
10/17/2021,New York,19795791,239,163292,2137,489
10/18/2021,New York,19795791,222,163514,2195,498
10/19/2021,New York,19795791,262,163776,2142,500
10/20/2021,New York,19795791,279,164055,2123,491
10/21/2021,New York,19795791,255,164310,2096,484
10/22/2021,New York,19795791,264,164574,2070,484
10/23/2021,New York,19795791,281,164855,2034,487
10/24/2021,New York,19795791,214,165069,2051,475
10/25/2021,New York,19795791,210,165279,2065,481
10/26/2021,New York,19795791,246,165525,2006,464
10/27/2021,New York,19795791,245,165770,1982,487
10/28/2021,New York,19795791,263,166033,1949,484
10/29/2021,New York,19795791,228,166261,1865,464
10/30/2021,New York,19795791,228,166489,1866,470
10/31/2021,New York,19795791,218,166707,1863,450
11/1/2021,New York,19795791,219,166926,1946,460
11/2/2021,New York,19795791,254,167180,1897,450
11/3/2021,New York,19795791,246,167426,1891,425
11/4/2021,New York,19795791,245,167671,1868,410
11/5/2021,New York,19795791,226,167897,1838,414
11/6/2021,New York,19795791,227,168124,1813,418
11/7/2021,New York,19795791,217,168341,1797,396
11/8/2021,New York,19795791,237,168578,1871,398
11/9/2021,New York,19795791,303,168881,1882,396
11/10/2021,New York,19795791,248,169129,1834,382
11/11/2021,New York,19795791,275,169404,1879,383
11/12/2021,New York,19795791,252,169656,1860,387
11/13/2021,New York,19795791,300,169956,1914,412
11/14/2021,New York,19795791,241,170197,1974,418
11/15/2021,New York,19795791,257,170454,2053,441
11/16/2021,New York,19795791,331,170785,2112,430
11/17/2021,New York,19795791,342,171127,2153,429
11/18/2021,New York,19795791,352,171479,2178,442
11/19/2021,New York,19795791,361,171840,2288,461
11/20/2021,New York,19795791,355,172195,2321,461
11/21/2021,New York,19795791,305,172500,2399,487
11/22/2021,New York,19795791,362,172862,2525,482
11/23/2021,New York,19795791,405,173267,2613,497
11/24/2021,New York,19795791,383,173650,2604,508
11/25/2021,New York,19795791,361,174011,2559,507
11/26/2021,New York,19795791,409,174420,2690,530
11/27/2021,New York,19795791,414,174834,2750,551
11/28/2021,New York,19795791,342,175176,2852,576
11/29/2021,New York,19795791,396,175572,3016,592
11/30/2021,New York,19795791,463,176035,3016,603
12/1/2021,New York,19795791,478,176513,3094,602
12/2/2021,New York,19795791,443,176956,3088,615
12/3/2021,New York,19795791,490,177446,3179,630
12/4/2021,New York,19795791,444,177890,3232,631
12/5/2021,New York,19795791,386,178276,3295,652
12/6/2021,New York,19795791,400,178676,3419,651
12/7/2021,New York,19795791,531,179207,3502,680
12/8/2021,New York,19795791,491,179698,3531,683
12/9/2021,New York,19795791,493,180191,3548,694
12/10/2021,New York,19795791,504,180695,3594,699
12/11/2021,New York,19795791,476,181171,3577,723
12/12/2021,New York,19795791,449,181620,3696,756
12/13/2021,New York,19795791,386,182006,3796,757
12/14/2021,New York,19795791,504,182510,3791,743
12/15/2021,New York,19795791,531,183041,3782,753
12/16/2021,New York,19795791,526,183567,3851,731
12/17/2021,New York,19795791,593,184160,3953,743
12/18/2021,New York,19795791,543,184703,3909,768
12/19/2021,New York,19795791,485,185188,4029,776
12/20/2021,New York,19795791,593,185781,4322,800
12/21/2021,New York,19795791,682,186463,4425,816
12/22/2021,New York,19795791,698,187161,4627,830
12/23/2021,New York,19795791,838,187999,4843,857
12/24/2021,New York,19795791,790,188789,5006,867
12/25/2021,New York,19795791,721,189510,5144,864
12/26/2021,New York,19795791,897,190407,5669,899
12/27/2021,New York,19795791,1002,191409,6260,939
12/28/2021,New York,19795791,1236,192645,6835,955
12/29/2021,New York,19795791,1419,194064,7602,1052
12/30/2021,New York,19795791,1549,195613,8077,1114
12/31/2021,New York,19795791,1593,197206,8588,1119
1/1/2022,New York,19795791,1405,198611,8821,1136
1/2/2022,New York,19795791,1440,200051,9568,1207
1/3/2022,New York,19795791,1544,201595,10259,1289
1/4/2022,New York,19795791,1796,203391,10710,1325
1/5/2022,New York,19795791,1790,205181,11292,1361
1/6/2022,New York,19795791,1849,207030,11678,1398
1/7/2022,New York,19795791,1914,208944,11998,1457
1/8/2022,New York,19795791,1658,210602,11945,1496
1/9/2022,New York,19795791,1401,212003,12153,1519
1/10/2022,New York,19795791,1526,213529,12556,1549
1/11/2022,New York,19795791,1829,215358,12731,1584
1/12/2022,New York,19795791,1747,217105,12731,1591
1/13/2022,New York,19795791,1593,218698,12469,1601
1/14/2022,New York,19795791,1761,220459,12406,1633
1/15/2022,New York,19795791,1499,221958,11920,1577
1/16/2022,New York,19795791,1116,223074,11957,1581
1/17/2022,New York,19795791,1105,224179,12003,1543
1/18/2022,New York,19795791,1288,225467,12097,1575
1/19/2022,New York,19795791,1405,226872,11854,1567
1/20/2022,New York,19795791,1256,228128,11326,1537
1/21/2022,New York,19795791,1222,229350,10761,1482
1/22/2022,New York,19795791,1094,230444,10153,1446
1/23/2022,New York,19795791,920,231364,9948,1410
1/24/2022,New York,19795791,896,232260,9968,1397
1/25/2022,New York,19795791,995,233255,9476,1325
1/26/2022,New York,19795791,910,234165,8816,1262
1/27/2022,New York,19795791,837,235002,8286,1214
1/28/2022,New York,19795791,799,235801,7890,1189
1/29/2022,New York,19795791,681,236482,7128,1119
1/30/2022,New York,19795791,470,236952,7325,1134
1/31/2022,New York,19795791,511,237463,7090,1102
2/1/2022,New York,19795791,653,238116,6696,1090
2/2/2022,New York,19795791,646,238762,6302,964
2/3/2022,New York,19795791,597,239359,5949,908
2/4/2022,New York,19795791,575,239934,5621,868
2/5/2022,New York,19795791,581,240515,5285,832
2/6/2022,New York,19795791,470,240985,5204,806
2/7/2022,New York,19795791,364,241349,5109,786
2/8/2022,New York,19795791,431,241780,4864,768
2/9/2022,New York,19795791,409,242189,4623,743
7/1/2021,Ohio,11613423,37,89796,281,74
7/2/2021,Ohio,11613423,34,89830,257,71
7/3/2021,Ohio,11613423,48,89878,239,73
7/4/2021,Ohio,11613423,28,89906,233,72
7/5/2021,Ohio,11613423,25,89931,228,75
7/6/2021,Ohio,11613423,50,89981,207,62
7/7/2021,Ohio,11613423,73,90054,219,60
7/8/2021,Ohio,11613423,63,90117,223,58
7/9/2021,Ohio,11613423,66,90183,214,56
7/10/2021,Ohio,11613423,69,90252,234,54
7/11/2021,Ohio,11613423,38,90290,242,52
7/12/2021,Ohio,11613423,59,90349,275,70
7/13/2021,Ohio,11613423,66,90415,274,66
7/14/2021,Ohio,11613423,68,90483,297,71
7/15/2021,Ohio,11613423,77,90560,297,68
7/16/2021,Ohio,11613423,63,90623,306,69
7/17/2021,Ohio,11613423,53,90676,314,67
7/18/2021,Ohio,11613423,45,90721,322,71
7/19/2021,Ohio,11613423,55,90776,326,72
7/20/2021,Ohio,11613423,103,90879,359,84
7/21/2021,Ohio,11613423,83,90962,376,90
7/22/2021,Ohio,11613423,97,91059,390,90
7/23/2021,Ohio,11613423,89,91148,400,94
7/24/2021,Ohio,11613423,72,91220,417,100
7/25/2021,Ohio,11613423,87,91307,446,110
7/26/2021,Ohio,11613423,94,91401,496,137
7/27/2021,Ohio,11613423,114,91515,539,148
7/28/2021,Ohio,11613423,127,91642,581,164
7/29/2021,Ohio,11613423,83,91725,588,177
7/30/2021,Ohio,11613423,135,91860,642,186
7/31/2021,Ohio,11613423,104,91964,640,190
8/1/2021,Ohio,11613423,93,92057,661,211
8/2/2021,Ohio,11613423,150,92207,726,220
8/3/2021,Ohio,11613423,178,92385,798,226
8/4/2021,Ohio,11613423,164,92549,802,244
8/5/2021,Ohio,11613423,161,92710,862,245
8/6/2021,Ohio,11613423,170,92880,909,248
8/7/2021,Ohio,11613423,150,93030,941,267
8/8/2021,Ohio,11613423,158,93188,985,270
8/9/2021,Ohio,11613423,158,93346,1044,294
8/10/2021,Ohio,11613423,212,93558,1090,322
8/11/2021,Ohio,11613423,207,93765,1186,355
8/12/2021,Ohio,11613423,231,93996,1219,372
8/13/2021,Ohio,11613423,230,94226,1265,391
8/14/2021,Ohio,11613423,212,94438,1346,411
8/15/2021,Ohio,11613423,202,94640,1360,437
8/16/2021,Ohio,11613423,261,94901,1451,456
8/17/2021,Ohio,11613423,290,95191,1572,472
8/18/2021,Ohio,11613423,289,95480,1634,499
8/19/2021,Ohio,11613423,263,95743,1669,513
8/20/2021,Ohio,11613423,276,96019,1728,549
8/21/2021,Ohio,11613423,279,96298,1807,557
8/22/2021,Ohio,11613423,250,96548,1883,575
8/23/2021,Ohio,11613423,316,96864,1978,605
8/24/2021,Ohio,11613423,361,97225,2100,615
8/25/2021,Ohio,11613423,289,97514,2147,629
8/26/2021,Ohio,11613423,301,97815,2122,641
8/27/2021,Ohio,11613423,319,98134,2121,630
8/28/2021,Ohio,11613423,328,98462,2165,659
8/29/2021,Ohio,11613423,333,98795,2262,657
8/30/2021,Ohio,11613423,368,99163,2369,696
8/31/2021,Ohio,11613423,390,99553,2461,718
9/1/2021,Ohio,11613423,423,99976,2539,748
9/2/2021,Ohio,11613423,447,100423,2572,761
9/3/2021,Ohio,11613423,427,100850,2629,772
9/4/2021,Ohio,11613423,383,101233,2639,787
9/5/2021,Ohio,11613423,378,101611,2717,790
9/6/2021,Ohio,11613423,413,102024,2825,820
9/7/2021,Ohio,11613423,493,102517,2988,854
9/8/2021,Ohio,11613423,506,103023,3172,845
9/9/2021,Ohio,11613423,492,103515,3209,877
9/10/2021,Ohio,11613423,504,104019,3249,894
9/11/2021,Ohio,11613423,455,104474,3244,886
9/12/2021,Ohio,11613423,423,104897,3297,899
9/13/2021,Ohio,11613423,505,105402,3394,917
9/14/2021,Ohio,11613423,544,105946,3472,936
9/15/2021,Ohio,11613423,563,106509,3569,934
9/16/2021,Ohio,11613423,568,107077,3595,945
9/17/2021,Ohio,11613423,554,107631,3560,964
9/18/2021,Ohio,11613423,508,108139,3527,960
9/19/2021,Ohio,11613423,455,108594,3554,980
9/20/2021,Ohio,11613423,489,109083,3668,1008
9/21/2021,Ohio,11613423,570,109653,3726,1029
9/22/2021,Ohio,11613423,550,110203,3715,1042
9/23/2021,Ohio,11613423,511,110714,3716,1054
9/24/2021,Ohio,11613423,544,111258,3720,1029
9/25/2021,Ohio,11613423,516,111774,3683,992
9/26/2021,Ohio,11613423,446,112220,3669,989
9/27/2021,Ohio,11613423,465,112685,3727,990
9/28/2021,Ohio,11613423,547,113232,3722,996
9/29/2021,Ohio,11613423,527,113759,3710,983
9/30/2021,Ohio,11613423,444,114203,3621,989
10/1/2021,Ohio,11613423,457,114660,3563,952
10/2/2021,Ohio,11613423,456,115116,3470,971
10/3/2021,Ohio,11613423,414,115530,3515,949
10/4/2021,Ohio,11613423,401,115931,3552,966
10/5/2021,Ohio,11613423,482,116413,3550,936
10/6/2021,Ohio,11613423,475,116888,3513,978
10/7/2021,Ohio,11613423,465,117353,3469,959
10/8/2021,Ohio,11613423,430,117783,3475,951
10/9/2021,Ohio,11613423,433,118216,3456,926
10/10/2021,Ohio,11613423,376,118592,3427,921
10/11/2021,Ohio,11613423,395,118987,3469,950
10/12/2021,Ohio,11613423,436,119423,3443,945
10/13/2021,Ohio,11613423,474,119897,3412,937
10/14/2021,Ohio,11613423,428,120325,3298,931
10/15/2021,Ohio,11613423,447,120772,3244,941
10/16/2021,Ohio,11613423,340,121112,3083,910
10/17/2021,Ohio,11613423,340,121452,3088,922
10/18/2021,Ohio,11613423,355,121807,3050,896
10/19/2021,Ohio,11613423,406,122213,3030,873
10/20/2021,Ohio,11613423,396,122609,2941,848
10/21/2021,Ohio,11613423,364,122973,2833,809
10/22/2021,Ohio,11613423,375,123348,2848,797
10/23/2021,Ohio,11613423,322,123670,2735,782
10/24/2021,Ohio,11613423,259,123929,2690,772
10/25/2021,Ohio,11613423,300,124229,2634,769
10/26/2021,Ohio,11613423,346,124575,2618,751
10/27/2021,Ohio,11613423,304,124879,2507,724
10/28/2021,Ohio,11613423,260,125139,2408,710
10/29/2021,Ohio,11613423,323,125462,2408,708
10/30/2021,Ohio,11613423,362,125824,2388,696
10/31/2021,Ohio,11613423,315,126139,2426,689
11/1/2021,Ohio,11613423,297,126436,2436,687
11/2/2021,Ohio,11613423,332,126768,2412,686
11/3/2021,Ohio,11613423,333,127101,2422,688
11/4/2021,Ohio,11613423,350,127451,2392,685
11/5/2021,Ohio,11613423,316,127767,2307,661
11/6/2021,Ohio,11613423,288,128055,2274,651
11/7/2021,Ohio,11613423,308,128363,2270,655
11/8/2021,Ohio,11613423,352,128715,2377,684
11/9/2021,Ohio,11613423,356,129071,2443,676
11/10/2021,Ohio,11613423,402,129473,2519,690
11/11/2021,Ohio,11613423,376,129849,2532,694
11/12/2021,Ohio,11613423,374,130223,2510,695
11/13/2021,Ohio,11613423,388,130611,2564,731
11/14/2021,Ohio,11613423,334,130945,2614,741
11/15/2021,Ohio,11613423,411,131356,2762,788
11/16/2021,Ohio,11613423,436,131792,2814,817
11/17/2021,Ohio,11613423,496,132288,2931,827
11/18/2021,Ohio,11613423,487,132775,3045,815
11/19/2021,Ohio,11613423,458,133233,3109,834
11/20/2021,Ohio,11613423,393,133626,3123,869
11/21/2021,Ohio,11613423,411,134037,3175,878
11/22/2021,Ohio,11613423,489,134526,3253,892
11/23/2021,Ohio,11613423,545,135071,3378,923
11/24/2021,Ohio,11613423,518,135589,3424,938
11/25/2021,Ohio,11613423,467,136056,3327,910
11/26/2021,Ohio,11613423,489,136545,3446,936
11/27/2021,Ohio,11613423,509,137054,3523,955
11/28/2021,Ohio,11613423,473,137527,3658,968
11/29/2021,Ohio,11613423,510,138037,3797,977
11/30/2021,Ohio,11613423,570,138607,3880,985
12/1/2021,Ohio,11613423,594,139201,3955,999
12/2/2021,Ohio,11613423,576,139777,4022,1007
12/3/2021,Ohio,11613423,620,140397,4076,1041
12/4/2021,Ohio,11613423,571,140968,4075,1034
12/5/2021,Ohio,11613423,532,141500,4157,1040
12/6/2021,Ohio,11613423,562,142062,4272,1076
12/7/2021,Ohio,11613423,594,142656,4314,1102
12/8/2021,Ohio,11613423,680,143336,4378,1117
12/9/2021,Ohio,11613423,687,144023,4442,1129
12/10/2021,Ohio,11613423,667,144690,4557,1138
12/11/2021,Ohio,11613423,634,145324,4638,1128
12/12/2021,Ohio,11613423,615,145939,4740,1188
12/13/2021,Ohio,11613423,566,146505,4807,1207
12/14/2021,Ohio,11613423,605,147110,4832,1188
12/15/2021,Ohio,11613423,608,147718,4835,1199
12/16/2021,Ohio,11613423,696,148414,4827,1173
12/17/2021,Ohio,11613423,711,149125,4875,1197
12/18/2021,Ohio,11613423,638,149763,4776,1212
12/19/2021,Ohio,11613423,561,150324,4779,1187
12/20/2021,Ohio,11613423,567,150891,4881,1223
12/21/2021,Ohio,11613423,626,151517,4896,1217
12/22/2021,Ohio,11613423,695,152212,4869,1220
12/23/2021,Ohio,11613423,683,152895,4850,1210
12/24/2021,Ohio,11613423,650,153545,4773,1217
12/25/2021,Ohio,11613423,612,154157,4732,1219
12/26/2021,Ohio,11613423,637,154794,4898,1208
12/27/2021,Ohio,11613423,678,155472,5144,1216
12/28/2021,Ohio,11613423,837,156309,5343,1204
12/29/2021,Ohio,11613423,888,157197,5493,1232
12/30/2021,Ohio,11613423,908,158105,5620,1250
12/31/2021,Ohio,11613423,997,159102,5807,1245
1/1/2022,Ohio,11613423,966,160068,5908,1263
1/2/2022,Ohio,11613423,868,160936,6073,1314
1/3/2022,Ohio,11613423,879,161815,6373,1352
1/4/2022,Ohio,11613423,957,162772,6475,1331
1/5/2022,Ohio,11613423,1121,163893,6711,1359
1/6/2022,Ohio,11613423,1109,165002,6803,1345
1/7/2022,Ohio,11613423,1094,166096,6837,1362
1/8/2022,Ohio,11613423,1036,167132,6811,1349
1/9/2022,Ohio,11613423,988,168120,6866,1366
1/10/2022,Ohio,11613423,949,169069,6970,1324
1/11/2022,Ohio,11613423,955,170024,6897,1310
1/12/2022,Ohio,11613423,1043,171067,6882,1283
1/13/2022,Ohio,11613423,1078,172145,6849,1277
1/14/2022,Ohio,11613423,1058,173203,6726,1271
1/15/2022,Ohio,11613423,1031,174234,6507,1277
1/16/2022,Ohio,11613423,816,175050,6339,1243
1/17/2022,Ohio,11613423,655,175705,6269,1207
1/18/2022,Ohio,11613423,737,176442,6179,1203
1/19/2022,Ohio,11613423,862,177304,6071,1195
1/20/2022,Ohio,11613423,854,178158,5922,1178
1/21/2022,Ohio,11613423,833,178991,5802,1158
1/22/2022,Ohio,11613423,797,179788,5572,1148
1/23/2022,Ohio,11613423,655,180443,5535,1074
1/24/2022,Ohio,11613423,618,181061,5460,1094
1/25/2022,Ohio,11613423,758,181819,5323,1037
1/26/2022,Ohio,11613423,695,182514,5189,1015
1/27/2022,Ohio,11613423,715,183229,4950,952
1/28/2022,Ohio,11613423,675,183904,4751,908
1/29/2022,Ohio,11613423,574,184478,4471,868
1/30/2022,Ohio,11613423,523,185001,4371,817
1/31/2022,Ohio,11613423,430,185431,4216,799
2/1/2022,Ohio,11613423,579,186010,4134,791
2/2/2022,Ohio,11613423,555,186565,3932,745
2/3/2022,Ohio,11613423,510,187075,3642,727
2/4/2022,Ohio,11613423,377,187452,3573,726
2/5/2022,Ohio,11613423,350,187802,3376,676
2/6/2022,Ohio,11613423,369,188171,3255,658
2/7/2022,Ohio,11613423,333,188504,3173,634
2/8/2022,Ohio,11613423,429,188933,3130,622
2/9/2022,Ohio,11613423,429,189362,3130,622
7/1/2021,Oklahoma,3911338,45,50694,215,58
7/2/2021,Oklahoma,3911338,37,50731,203,53
7/3/2021,Oklahoma,3911338,47,50778,211,60
7/4/2021,Oklahoma,3911338,43,50821,211,66
7/5/2021,Oklahoma,3911338,46,50867,218,67
7/6/2021,Oklahoma,3911338,50,50917,233,64
7/7/2021,Oklahoma,3911338,70,50987,258,74
7/8/2021,Oklahoma,3911338,69,51056,269,76
7/9/2021,Oklahoma,3911338,58,51114,269,83
7/10/2021,Oklahoma,3911338,61,51175,264,78
7/11/2021,Oklahoma,3911338,70,51245,288,85
7/12/2021,Oklahoma,3911338,58,51303,295,95
7/13/2021,Oklahoma,3911338,83,51386,327,107
7/14/2021,Oklahoma,3911338,76,51462,360,113
7/15/2021,Oklahoma,3911338,100,51562,396,121
7/16/2021,Oklahoma,3911338,84,51646,412,124
7/17/2021,Oklahoma,3911338,89,51735,417,138
7/18/2021,Oklahoma,3911338,82,51817,419,140
7/19/2021,Oklahoma,3911338,79,51896,445,144
7/20/2021,Oklahoma,3911338,97,51993,483,156
7/21/2021,Oklahoma,3911338,109,52102,510,161
7/22/2021,Oklahoma,3911338,99,52201,528,172
7/23/2021,Oklahoma,3911338,110,52311,543,174
7/24/2021,Oklahoma,3911338,133,52444,570,184
7/25/2021,Oklahoma,3911338,121,52565,589,193
7/26/2021,Oklahoma,3911338,144,52709,656,211
7/27/2021,Oklahoma,3911338,155,52864,713,215
7/28/2021,Oklahoma,3911338,172,53036,763,233
7/29/2021,Oklahoma,3911338,185,53221,826,238
7/30/2021,Oklahoma,3911338,189,53410,828,237
7/31/2021,Oklahoma,3911338,213,53623,877,249
8/1/2021,Oklahoma,3911338,205,53828,889,260
8/2/2021,Oklahoma,3911338,179,54007,931,271
8/3/2021,Oklahoma,3911338,228,54235,985,288
8/4/2021,Oklahoma,3911338,235,54470,1037,296
8/5/2021,Oklahoma,3911338,243,54713,1099,294
8/6/2021,Oklahoma,3911338,228,54941,1133,306
8/7/2021,Oklahoma,3911338,276,55217,1174,321
8/8/2021,Oklahoma,3911338,257,55474,1218,333
8/9/2021,Oklahoma,3911338,260,55734,1284,346
8/10/2021,Oklahoma,3911338,308,56042,1359,367
8/11/2021,Oklahoma,3911338,308,56350,1370,368
8/12/2021,Oklahoma,3911338,306,56656,1431,371
8/13/2021,Oklahoma,3911338,272,56928,1456,381
8/14/2021,Oklahoma,3911338,295,57223,1455,391
8/15/2021,Oklahoma,3911338,266,57489,1483,395
8/16/2021,Oklahoma,3911338,295,57784,1493,402
8/17/2021,Oklahoma,3911338,313,58097,1533,399
8/18/2021,Oklahoma,3911338,327,58424,1547,416
8/19/2021,Oklahoma,3911338,317,58741,1518,430
8/20/2021,Oklahoma,3911338,322,59063,1541,427
8/21/2021,Oklahoma,3911338,290,59353,1581,422
8/22/2021,Oklahoma,3911338,289,59642,1596,422
8/23/2021,Oklahoma,3911338,292,59934,1640,434
8/24/2021,Oklahoma,3911338,286,60220,1639,435
8/25/2021,Oklahoma,3911338,342,60562,1593,422
8/26/2021,Oklahoma,3911338,310,60872,1606,427
8/27/2021,Oklahoma,3911338,327,61199,1597,431
8/28/2021,Oklahoma,3911338,312,61511,1570,431
8/29/2021,Oklahoma,3911338,291,61802,1579,453
8/30/2021,Oklahoma,3911338,279,62081,1584,445
8/31/2021,Oklahoma,3911338,330,62411,1620,456
9/1/2021,Oklahoma,3911338,331,62742,1606,449
9/2/2021,Oklahoma,3911338,331,63073,1589,428
9/3/2021,Oklahoma,3911338,310,63383,1574,424
9/4/2021,Oklahoma,3911338,281,63664,1500,414
9/5/2021,Oklahoma,3911338,297,63961,1553,425
9/6/2021,Oklahoma,3911338,282,64243,1555,426
9/7/2021,Oklahoma,3911338,289,64532,1594,428
9/8/2021,Oklahoma,3911338,317,64849,1571,422
9/9/2021,Oklahoma,3911338,326,65175,1499,399
9/10/2021,Oklahoma,3911338,299,65474,1464,398
9/11/2021,Oklahoma,3911338,298,65772,1429,401
9/12/2021,Oklahoma,3911338,266,66038,1426,402
9/13/2021,Oklahoma,3911338,288,66326,1473,417
9/14/2021,Oklahoma,3911338,296,66622,1397,390
9/15/2021,Oklahoma,3911338,287,66909,1402,381
9/16/2021,Oklahoma,3911338,301,67210,1412,392
9/17/2021,Oklahoma,3911338,269,67479,1384,387
9/18/2021,Oklahoma,3911338,279,67758,1357,388
9/19/2021,Oklahoma,3911338,247,68005,1320,386
9/20/2021,Oklahoma,3911338,232,68237,1292,379
9/21/2021,Oklahoma,3911338,282,68519,1283,364
9/22/2021,Oklahoma,3911338,219,68738,1238,373
9/23/2021,Oklahoma,3911338,240,68978,1205,359
9/24/2021,Oklahoma,3911338,231,69209,1188,364
9/25/2021,Oklahoma,3911338,203,69412,1123,358
9/26/2021,Oklahoma,3911338,192,69604,1119,359
9/27/2021,Oklahoma,3911338,182,69786,1121,346
9/28/2021,Oklahoma,3911338,202,69988,1086,333
9/29/2021,Oklahoma,3911338,194,70182,1094,330
9/30/2021,Oklahoma,3911338,218,70400,1050,319
10/1/2021,Oklahoma,3911338,185,70585,1012,305
10/2/2021,Oklahoma,3911338,189,70774,957,297
10/3/2021,Oklahoma,3911338,177,70951,944,301
10/4/2021,Oklahoma,3911338,184,71135,953,306
10/5/2021,Oklahoma,3911338,200,71335,944,289
10/6/2021,Oklahoma,3911338,197,71532,899,275
10/7/2021,Oklahoma,3911338,202,71734,878,264
10/8/2021,Oklahoma,3911338,192,71926,864,255
10/9/2021,Oklahoma,3911338,159,72085,832,263
10/10/2021,Oklahoma,3911338,170,72255,823,265
10/11/2021,Oklahoma,3911338,150,72405,826,259
10/12/2021,Oklahoma,3911338,159,72564,808,249
10/13/2021,Oklahoma,3911338,143,72707,794,244
10/14/2021,Oklahoma,3911338,165,72872,774,231
10/15/2021,Oklahoma,3911338,132,73004,742,234
10/16/2021,Oklahoma,3911338,112,73116,707,221
10/17/2021,Oklahoma,3911338,116,73232,675,223
10/18/2021,Oklahoma,3911338,123,73355,682,226
10/19/2021,Oklahoma,3911338,124,73479,675,218
10/20/2021,Oklahoma,3911338,132,73611,696,221
10/21/2021,Oklahoma,3911338,122,73733,660,221
10/22/2021,Oklahoma,3911338,104,73837,608,204
10/23/2021,Oklahoma,3911338,95,73932,563,197
10/24/2021,Oklahoma,3911338,92,74024,568,193
10/25/2021,Oklahoma,3911338,87,74111,562,193
10/26/2021,Oklahoma,3911338,102,74213,559,185
10/27/2021,Oklahoma,3911338,100,74313,549,177
10/28/2021,Oklahoma,3911338,101,74414,534,173
10/29/2021,Oklahoma,3911338,95,74509,502,166
10/30/2021,Oklahoma,3911338,102,74611,498,161
10/31/2021,Oklahoma,3911338,92,74703,491,159
11/1/2021,Oklahoma,3911338,65,74768,471,162
11/2/2021,Oklahoma,3911338,85,74853,485,164
11/3/2021,Oklahoma,3911338,84,74937,479,155
11/4/2021,Oklahoma,3911338,104,75041,473,152
11/5/2021,Oklahoma,3911338,85,75126,465,150
11/6/2021,Oklahoma,3911338,95,75221,453,145
11/7/2021,Oklahoma,3911338,78,75299,446,136
11/8/2021,Oklahoma,3911338,87,75386,433,140
11/9/2021,Oklahoma,3911338,97,75483,445,149
11/10/2021,Oklahoma,3911338,107,75590,479,158
11/11/2021,Oklahoma,3911338,109,75699,464,151
11/12/2021,Oklahoma,3911338,100,75799,462,152
11/13/2021,Oklahoma,3911338,104,75903,465,145
11/14/2021,Oklahoma,3911338,67,75970,469,146
11/15/2021,Oklahoma,3911338,73,76043,452,151
11/16/2021,Oklahoma,3911338,111,76154,488,159
11/17/2021,Oklahoma,3911338,99,76253,483,155
11/18/2021,Oklahoma,3911338,106,76359,500,159
11/19/2021,Oklahoma,3911338,96,76455,496,156
11/20/2021,Oklahoma,3911338,70,76525,489,160
11/21/2021,Oklahoma,3911338,72,76597,485,158
11/22/2021,Oklahoma,3911338,85,76682,494,160
11/23/2021,Oklahoma,3911338,104,76786,495,163
11/24/2021,Oklahoma,3911338,94,76880,497,152
11/25/2021,Oklahoma,3911338,96,76976,518,170
11/26/2021,Oklahoma,3911338,74,77050,521,169
11/27/2021,Oklahoma,3911338,97,77147,529,171
11/28/2021,Oklahoma,3911338,91,77238,542,168
11/29/2021,Oklahoma,3911338,107,77345,544,167
11/30/2021,Oklahoma,3911338,114,77459,560,175
12/1/2021,Oklahoma,3911338,137,77596,587,179
12/2/2021,Oklahoma,3911338,128,77724,582,173
12/3/2021,Oklahoma,3911338,134,77858,594,180
12/4/2021,Oklahoma,3911338,119,77977,603,179
12/5/2021,Oklahoma,3911338,119,78096,615,180
12/6/2021,Oklahoma,3911338,143,78239,645,192
12/7/2021,Oklahoma,3911338,161,78400,677,203
12/8/2021,Oklahoma,3911338,157,78557,714,219
12/9/2021,Oklahoma,3911338,174,78731,727,220
12/10/2021,Oklahoma,3911338,174,78905,755,232
12/11/2021,Oklahoma,3911338,160,79065,762,225
12/12/2021,Oklahoma,3911338,152,79217,770,232
12/13/2021,Oklahoma,3911338,150,79367,760,239
12/14/2021,Oklahoma,3911338,181,79548,770,233
12/15/2021,Oklahoma,3911338,169,79717,788,239
12/16/2021,Oklahoma,3911338,150,79867,784,234
12/17/2021,Oklahoma,3911338,158,80025,780,235
12/18/2021,Oklahoma,3911338,124,80149,766,232
12/19/2021,Oklahoma,3911338,133,80282,766,245
12/20/2021,Oklahoma,3911338,151,80433,778,248
12/21/2021,Oklahoma,3911338,170,80603,787,241
12/22/2021,Oklahoma,3911338,178,80781,820,249
12/23/2021,Oklahoma,3911338,148,80929,841,257
12/24/2021,Oklahoma,3911338,160,81089,838,266
12/25/2021,Oklahoma,3911338,153,81242,838,248
12/26/2021,Oklahoma,3911338,173,81415,859,245
12/27/2021,Oklahoma,3911338,161,81576,885,266
12/28/2021,Oklahoma,3911338,203,81779,936,268
12/29/2021,Oklahoma,3911338,211,81990,991,269
12/30/2021,Oklahoma,3911338,222,82212,1045,274
12/31/2021,Oklahoma,3911338,202,82414,1034,276
1/1/2022,Oklahoma,3911338,213,82627,1037,270
1/2/2022,Oklahoma,3911338,209,82836,1083,280
1/3/2022,Oklahoma,3911338,190,83026,1102,296
1/4/2022,Oklahoma,3911338,240,83266,1139,299
1/5/2022,Oklahoma,3911338,273,83539,1209,304
1/6/2022,Oklahoma,3911338,266,83805,1253,316
1/7/2022,Oklahoma,3911338,272,84077,1304,326
1/8/2022,Oklahoma,3911338,255,84332,1312,322
1/9/2022,Oklahoma,3911338,276,84608,1357,317
1/10/2022,Oklahoma,3911338,309,84917,1470,333
1/11/2022,Oklahoma,3911338,351,85268,1521,341
1/12/2022,Oklahoma,3911338,399,85667,1607,341
1/13/2022,Oklahoma,3911338,386,86053,1705,365
1/14/2022,Oklahoma,3911338,421,86474,1741,362
1/15/2022,Oklahoma,3911338,393,86867,1756,373
1/16/2022,Oklahoma,3911338,374,87241,1784,365
1/17/2022,Oklahoma,3911338,391,87632,1835,380
1/18/2022,Oklahoma,3911338,494,88126,1949,379
1/19/2022,Oklahoma,3911338,468,88594,2076,392
1/20/2022,Oklahoma,3911338,480,89074,2106,409
1/21/2022,Oklahoma,3911338,490,89564,2144,416
1/22/2022,Oklahoma,3911338,468,90032,2118,403
1/23/2022,Oklahoma,3911338,450,90482,2158,418
1/24/2022,Oklahoma,3911338,486,90968,2261,422
1/25/2022,Oklahoma,3911338,579,91547,2340,439
1/26/2022,Oklahoma,3911338,440,91987,2392,442
1/27/2022,Oklahoma,3911338,534,92521,2373,432
1/28/2022,Oklahoma,3911338,545,93066,2292,427
1/29/2022,Oklahoma,3911338,496,93562,2185,417
1/30/2022,Oklahoma,3911338,424,93986,2163,430
1/31/2022,Oklahoma,3911338,440,94426,2190,446
2/1/2022,Oklahoma,3911338,478,94904,2197,442
2/2/2022,Oklahoma,3911338,443,95347,2076,417
2/3/2022,Oklahoma,3911338,424,95771,1997,412
2/4/2022,Oklahoma,3911338,341,96112,1950,402
2/5/2022,Oklahoma,3911338,361,96473,1799,358
2/6/2022,Oklahoma,3911338,363,96836,1776,359
2/7/2022,Oklahoma,3911338,317,97153,1753,370
2/8/2022,Oklahoma,3911338,335,97488,1665,362
2/9/2022,Oklahoma,3911338,335,97823,1665,362
7/1/2021,Oregon,4028977,10,10800,137,28
7/2/2021,Oregon,4028977,16,10816,140,28
7/3/2021,Oregon,4028977,22,10838,147,33
7/4/2021,Oregon,4028977,9,10847,146,31
7/5/2021,Oregon,4028977,11,10858,129,26
7/6/2021,Oregon,4028977,8,10866,134,30
7/7/2021,Oregon,4028977,12,10878,118,30
7/8/2021,Oregon,4028977,13,10891,115,30
7/9/2021,Oregon,4028977,12,10903,109,24
7/10/2021,Oregon,4028977,18,10921,115,26
7/11/2021,Oregon,4028977,16,10937,126,29
7/12/2021,Oregon,4028977,16,10953,120,27
7/13/2021,Oregon,4028977,14,10967,131,25
7/14/2021,Oregon,4028977,19,10986,134,31
7/15/2021,Oregon,4028977,16,11002,145,38
7/16/2021,Oregon,4028977,22,11024,142,37
7/17/2021,Oregon,4028977,19,11043,144,39
7/18/2021,Oregon,4028977,22,11065,157,43
7/19/2021,Oregon,4028977,19,11084,163,41
7/20/2021,Oregon,4028977,21,11105,165,41
7/21/2021,Oregon,4028977,12,11117,158,40
7/22/2021,Oregon,4028977,31,11148,173,41
7/23/2021,Oregon,4028977,26,11174,173,41
7/24/2021,Oregon,4028977,28,11202,178,52
7/25/2021,Oregon,4028977,29,11231,210,61
7/26/2021,Oregon,4028977,35,11266,222,70
7/27/2021,Oregon,4028977,46,11312,258,79
7/28/2021,Oregon,4028977,47,11359,280,80
7/29/2021,Oregon,4028977,40,11399,284,77
7/30/2021,Oregon,4028977,49,11448,312,88
7/31/2021,Oregon,4028977,39,11487,306,82
8/1/2021,Oregon,4028977,44,11531,337,96
8/2/2021,Oregon,4028977,38,11569,361,99
8/3/2021,Oregon,4028977,37,11606,380,105
8/4/2021,Oregon,4028977,58,11664,424,105
8/5/2021,Oregon,4028977,87,11751,472,112
8/6/2021,Oregon,4028977,95,11846,524,118
8/7/2021,Oregon,4028977,73,11919,564,125
8/8/2021,Oregon,4028977,77,11996,593,138
8/9/2021,Oregon,4028977,68,12064,607,144
8/10/2021,Oregon,4028977,78,12142,648,156
8/11/2021,Oregon,4028977,86,12228,670,161
8/12/2021,Oregon,4028977,103,12331,696,166
8/13/2021,Oregon,4028977,82,12413,734,175
8/14/2021,Oregon,4028977,80,12493,725,167
8/15/2021,Oregon,4028977,57,12550,719,165
8/16/2021,Oregon,4028977,80,12630,761,178
8/17/2021,Oregon,4028977,127,12757,876,201
8/18/2021,Oregon,4028977,96,12853,841,196
8/19/2021,Oregon,4028977,114,12967,861,195
8/20/2021,Oregon,4028977,126,13093,875,204
8/21/2021,Oregon,4028977,88,13181,899,196
8/22/2021,Oregon,4028977,100,13281,920,200
8/23/2021,Oregon,4028977,124,13405,964,212
8/24/2021,Oregon,4028977,135,13540,1038,228
8/25/2021,Oregon,4028977,140,13680,1071,245
8/26/2021,Oregon,4028977,150,13830,1091,258
8/27/2021,Oregon,4028977,129,13959,1111,268
8/28/2021,Oregon,4028977,135,14094,1122,264
8/29/2021,Oregon,4028977,127,14221,1143,278
8/30/2021,Oregon,4028977,135,14356,1155,273
8/31/2021,Oregon,4028977,122,14478,1160,281
9/1/2021,Oregon,4028977,132,14610,1151,273
9/2/2021,Oregon,4028977,106,14716,1137,251
9/3/2021,Oregon,4028977,139,14855,1151,256
9/4/2021,Oregon,4028977,146,15001,1137,257
9/5/2021,Oregon,4028977,132,15133,1140,251
9/6/2021,Oregon,4028977,100,15233,1162,256
9/7/2021,Oregon,4028977,119,15352,1122,264
9/8/2021,Oregon,4028977,106,15458,1093,263
9/9/2021,Oregon,4028977,148,15606,1138,244
9/10/2021,Oregon,4028977,120,15726,1146,231
9/11/2021,Oregon,4028977,139,15865,1117,247
9/12/2021,Oregon,4028977,120,15985,1086,251
9/13/2021,Oregon,4028977,106,16091,1093,257
9/14/2021,Oregon,4028977,111,16202,1080,255
9/15/2021,Oregon,4028977,133,16335,1069,262
9/16/2021,Oregon,4028977,106,16441,1062,265
9/17/2021,Oregon,4028977,86,16527,1008,263
9/18/2021,Oregon,4028977,93,16620,1010,247
9/19/2021,Oregon,4028977,91,16711,1018,251
9/20/2021,Oregon,4028977,82,16793,1002,236
9/21/2021,Oregon,4028977,93,16886,963,242
9/22/2021,Oregon,4028977,94,16980,977,249
9/23/2021,Oregon,4028977,78,17058,940,238
9/24/2021,Oregon,4028977,76,17134,890,235
9/25/2021,Oregon,4028977,86,17220,861,218
9/26/2021,Oregon,4028977,72,17292,855,199
9/27/2021,Oregon,4028977,65,17357,871,211
9/28/2021,Oregon,4028977,75,17432,860,225
9/29/2021,Oregon,4028977,78,17510,835,211
9/30/2021,Oregon,4028977,92,17602,813,194
10/1/2021,Oregon,4028977,79,17681,801,205
10/2/2021,Oregon,4028977,83,17764,796,198
10/3/2021,Oregon,4028977,57,17821,799,201
10/4/2021,Oregon,4028977,62,17883,797,193
10/5/2021,Oregon,4028977,67,17950,778,187
10/6/2021,Oregon,4028977,70,18020,773,181
10/7/2021,Oregon,4028977,65,18085,720,172
10/8/2021,Oregon,4028977,60,18145,702,171
10/9/2021,Oregon,4028977,75,18220,687,164
10/10/2021,Oregon,4028977,51,18271,683,169
10/11/2021,Oregon,4028977,46,18317,672,163
10/12/2021,Oregon,4028977,55,18372,642,149
10/13/2021,Oregon,4028977,67,18439,651,155
10/14/2021,Oregon,4028977,53,18492,622,149
10/15/2021,Oregon,4028977,55,18547,596,150
10/16/2021,Oregon,4028977,57,18604,572,134
10/17/2021,Oregon,4028977,32,18636,579,128
10/18/2021,Oregon,4028977,51,18687,594,135
10/19/2021,Oregon,4028977,50,18737,594,125
10/20/2021,Oregon,4028977,70,18807,598,125
10/21/2021,Oregon,4028977,44,18851,580,128
10/22/2021,Oregon,4028977,45,18896,557,131
10/23/2021,Oregon,4028977,57,18953,547,128
10/24/2021,Oregon,4028977,58,19011,565,126
10/25/2021,Oregon,4028977,52,19063,578,127
10/26/2021,Oregon,4028977,55,19118,578,127
10/27/2021,Oregon,4028977,57,19175,574,118
10/28/2021,Oregon,4028977,37,19212,538,120
10/29/2021,Oregon,4028977,42,19254,511,93
10/30/2021,Oregon,4028977,62,19316,540,117
10/31/2021,Oregon,4028977,45,19361,539,106
11/1/2021,Oregon,4028977,54,19415,531,104
11/2/2021,Oregon,4028977,51,19466,536,96
11/3/2021,Oregon,4028977,48,19514,541,95
11/4/2021,Oregon,4028977,58,19572,568,109
11/5/2021,Oregon,4028977,62,19634,560,117
11/6/2021,Oregon,4028977,51,19685,552,115
11/7/2021,Oregon,4028977,51,19736,554,117
11/8/2021,Oregon,4028977,51,19787,554,122
11/9/2021,Oregon,4028977,55,19842,549,122
11/10/2021,Oregon,4028977,53,19895,556,118
11/11/2021,Oregon,4028977,40,19935,515,115
11/12/2021,Oregon,4028977,45,19980,489,109
11/13/2021,Oregon,4028977,43,20023,483,110
11/14/2021,Oregon,4028977,34,20057,479,113
11/15/2021,Oregon,4028977,40,20097,491,104
11/16/2021,Oregon,4028977,51,20148,473,112
11/17/2021,Oregon,4028977,42,20190,455,99
11/18/2021,Oregon,4028977,46,20236,449,92
11/19/2021,Oregon,4028977,37,20273,431,92
11/20/2021,Oregon,4028977,38,20311,424,91
11/21/2021,Oregon,4028977,39,20350,428,89
11/22/2021,Oregon,4028977,36,20386,424,82
11/23/2021,Oregon,4028977,49,20435,442,84
11/24/2021,Oregon,4028977,46,20481,436,93
11/25/2021,Oregon,4028977,50,20531,416,88
11/26/2021,Oregon,4028977,29,20560,433,99
11/27/2021,Oregon,4028977,42,20602,418,82
11/28/2021,Oregon,4028977,44,20646,418,92
11/29/2021,Oregon,4028977,35,20681,427,88
11/30/2021,Oregon,4028977,46,20727,444,78
12/1/2021,Oregon,4028977,37,20764,430,85
12/2/2021,Oregon,4028977,37,20801,427,94
12/3/2021,Oregon,4028977,41,20842,416,95
12/4/2021,Oregon,4028977,42,20884,421,94
12/5/2021,Oregon,4028977,29,20913,421,102
12/6/2021,Oregon,4028977,43,20956,434,116
12/7/2021,Oregon,4028977,46,21002,425,104
12/8/2021,Oregon,4028977,56,21058,421,110
12/9/2021,Oregon,4028977,51,21109,423,102
12/10/2021,Oregon,4028977,43,21152,431,106
12/11/2021,Oregon,4028977,41,21193,428,106
12/12/2021,Oregon,4028977,36,21229,446,110
12/13/2021,Oregon,4028977,27,21256,426,98
12/14/2021,Oregon,4028977,36,21292,407,98
12/15/2021,Oregon,4028977,46,21338,424,106
12/16/2021,Oregon,4028977,39,21377,416,106
12/17/2021,Oregon,4028977,34,21411,400,106
12/18/2021,Oregon,4028977,26,21437,392,92
12/19/2021,Oregon,4028977,31,21468,381,102
12/20/2021,Oregon,4028977,33,21501,369,101
12/21/2021,Oregon,4028977,48,21549,388,96
12/22/2021,Oregon,4028977,39,21588,381,102
12/23/2021,Oregon,4028977,47,21635,378,109
12/24/2021,Oregon,4028977,40,21675,383,105
12/25/2021,Oregon,4028977,31,21706,385,90
12/26/2021,Oregon,4028977,33,21739,386,95
12/27/2021,Oregon,4028977,35,21774,397,95
12/28/2021,Oregon,4028977,57,21831,426,97
12/29/2021,Oregon,4028977,55,21886,449,100
12/30/2021,Oregon,4028977,68,21954,468,106
12/31/2021,Oregon,4028977,54,22008,462,101
1/1/2022,Oregon,4028977,55,22063,462,105
1/2/2022,Oregon,4028977,57,22120,482,106
1/3/2022,Oregon,4028977,54,22174,521,112
1/4/2022,Oregon,4028977,73,22247,555,115
1/5/2022,Oregon,4028977,65,22312,542,110
1/6/2022,Oregon,4028977,98,22410,591,106
1/7/2022,Oregon,4028977,87,22497,645,109
1/8/2022,Oregon,4028977,94,22591,645,111
1/9/2022,Oregon,4028977,85,22676,674,129
1/10/2022,Oregon,4028977,92,22768,723,140
1/11/2022,Oregon,4028977,81,22849,732,144
1/12/2022,Oregon,4028977,85,22934,692,116
1/13/2022,Oregon,4028977,126,23060,817,148
1/14/2022,Oregon,4028977,118,23178,838,156
1/15/2022,Oregon,4028977,111,23289,844,157
1/16/2022,Oregon,4028977,82,23371,853,148
1/17/2022,Oregon,4028977,97,23468,900,147
1/18/2022,Oregon,4028977,137,23605,959,148
1/19/2022,Oregon,4028977,121,23726,984,143
1/20/2022,Oregon,4028977,129,23855,1006,139
1/21/2022,Oregon,4028977,115,23970,1044,142
1/22/2022,Oregon,4028977,116,24086,1026,156
1/23/2022,Oregon,4028977,129,24215,1040,149
1/24/2022,Oregon,4028977,105,24320,1052,146
1/25/2022,Oregon,4028977,134,24454,1051,143
1/26/2022,Oregon,4028977,131,24585,1128,150
1/27/2022,Oregon,4028977,146,24731,1134,160
1/28/2022,Oregon,4028977,148,24879,1164,183
1/29/2022,Oregon,4028977,138,25017,1109,171
1/30/2022,Oregon,4028977,122,25139,1136,190
1/31/2022,Oregon,4028977,130,25269,1135,172
2/1/2022,Oregon,4028977,111,25380,1123,187
2/2/2022,Oregon,4028977,108,25488,1144,190
2/3/2022,Oregon,4028977,135,25623,1153,185
2/4/2022,Oregon,4028977,153,25776,1149,178
2/5/2022,Oregon,4028977,118,25894,1110,173
2/6/2022,Oregon,4028977,96,25990,1103,174
2/7/2022,Oregon,4028977,115,26105,1137,200
2/8/2022,Oregon,4028977,118,26223,1114,184
2/9/2022,Oregon,4028977,118,26341,1079,181
7/1/2021,Pennsylvania,12802503,40,93438,297,59
7/2/2021,Pennsylvania,12802503,41,93479,295,57
7/3/2021,Pennsylvania,12802503,42,93521,279,53
7/4/2021,Pennsylvania,12802503,36,93557,279,53
7/5/2021,Pennsylvania,12802503,37,93594,281,65
7/6/2021,Pennsylvania,12802503,36,93630,283,61
7/7/2021,Pennsylvania,12802503,46,93676,292,66
7/8/2021,Pennsylvania,12802503,33,93709,272,60
7/9/2021,Pennsylvania,12802503,40,93749,278,65
7/10/2021,Pennsylvania,12802503,28,93777,247,60
7/11/2021,Pennsylvania,12802503,22,93799,226,50
7/12/2021,Pennsylvania,12802503,23,93822,230,50
7/13/2021,Pennsylvania,12802503,24,93846,226,50
7/14/2021,Pennsylvania,12802503,37,93883,254,55
7/15/2021,Pennsylvania,12802503,33,93916,266,61
7/16/2021,Pennsylvania,12802503,55,93971,280,63
7/17/2021,Pennsylvania,12802503,50,94021,281,65
7/18/2021,Pennsylvania,12802503,24,94045,267,60
7/19/2021,Pennsylvania,12802503,40,94085,288,67
7/20/2021,Pennsylvania,12802503,43,94128,312,72
7/21/2021,Pennsylvania,12802503,69,94197,338,86
7/22/2021,Pennsylvania,12802503,74,94271,375,87
7/23/2021,Pennsylvania,12802503,49,94320,386,100
7/24/2021,Pennsylvania,12802503,41,94361,372,97
7/25/2021,Pennsylvania,12802503,66,94427,410,102
7/26/2021,Pennsylvania,12802503,63,94490,429,109
7/27/2021,Pennsylvania,12802503,67,94557,472,106
7/28/2021,Pennsylvania,12802503,77,94634,485,101
7/29/2021,Pennsylvania,12802503,75,94709,500,106
7/30/2021,Pennsylvania,12802503,78,94787,507,108
7/31/2021,Pennsylvania,12802503,81,94868,495,112
8/1/2021,Pennsylvania,12802503,74,94942,508,115
8/2/2021,Pennsylvania,12802503,99,95041,575,118
8/3/2021,Pennsylvania,12802503,94,95135,623,127
8/4/2021,Pennsylvania,12802503,72,95207,648,144
8/5/2021,Pennsylvania,12802503,110,95317,681,151
8/6/2021,Pennsylvania,12802503,126,95443,720,169
8/7/2021,Pennsylvania,12802503,120,95563,747,187
8/8/2021,Pennsylvania,12802503,120,95683,775,193
8/9/2021,Pennsylvania,12802503,108,95791,792,192
8/10/2021,Pennsylvania,12802503,146,95937,900,220
8/11/2021,Pennsylvania,12802503,155,96092,938,219
8/12/2021,Pennsylvania,12802503,168,96260,996,242
8/13/2021,Pennsylvania,12802503,160,96420,1050,255
8/14/2021,Pennsylvania,12802503,145,96565,1109,280
8/15/2021,Pennsylvania,12802503,134,96699,1103,289
8/16/2021,Pennsylvania,12802503,167,96866,1164,318
8/17/2021,Pennsylvania,12802503,199,97065,1262,343
8/18/2021,Pennsylvania,12802503,195,97260,1319,351
8/19/2021,Pennsylvania,12802503,169,97429,1333,347
8/20/2021,Pennsylvania,12802503,175,97604,1404,358
8/21/2021,Pennsylvania,12802503,196,97800,1435,382
8/22/2021,Pennsylvania,12802503,183,97983,1513,429
8/23/2021,Pennsylvania,12802503,184,98167,1596,443
8/24/2021,Pennsylvania,12802503,224,98391,1615,453
8/25/2021,Pennsylvania,12802503,231,98622,1680,489
8/26/2021,Pennsylvania,12802503,250,98872,1749,497
8/27/2021,Pennsylvania,12802503,245,99117,1783,486
8/28/2021,Pennsylvania,12802503,223,99340,1777,483
8/29/2021,Pennsylvania,12802503,203,99543,1769,475
8/30/2021,Pennsylvania,12802503,201,99744,1857,488
8/31/2021,Pennsylvania,12802503,236,99980,1849,481
9/1/2021,Pennsylvania,12802503,246,100226,1872,503
9/2/2021,Pennsylvania,12802503,239,100465,1923,492
9/3/2021,Pennsylvania,12802503,262,100727,1975,500
9/4/2021,Pennsylvania,12802503,239,100966,1933,486
9/5/2021,Pennsylvania,12802503,238,101204,1959,496
9/6/2021,Pennsylvania,12802503,254,101458,2045,514
9/7/2021,Pennsylvania,12802503,217,101675,2106,526
9/8/2021,Pennsylvania,12802503,267,101942,2109,524
9/9/2021,Pennsylvania,12802503,263,102205,2165,553
9/10/2021,Pennsylvania,12802503,306,102511,2213,545
9/11/2021,Pennsylvania,12802503,271,102782,2190,538
9/12/2021,Pennsylvania,12802503,248,103030,2223,537
9/13/2021,Pennsylvania,12802503,291,103321,2301,577
9/14/2021,Pennsylvania,12802503,293,103614,2377,590
9/15/2021,Pennsylvania,12802503,310,103924,2388,585
9/16/2021,Pennsylvania,12802503,281,104205,2334,593
9/17/2021,Pennsylvania,12802503,290,104495,2387,611
9/18/2021,Pennsylvania,12802503,312,104807,2398,603
9/19/2021,Pennsylvania,12802503,259,105066,2398,611
9/20/2021,Pennsylvania,12802503,263,105329,2440,618
9/21/2021,Pennsylvania,12802503,336,105665,2542,623
9/22/2021,Pennsylvania,12802503,326,105991,2573,651
9/23/2021,Pennsylvania,12802503,328,106319,2618,664
9/24/2021,Pennsylvania,12802503,355,106674,2687,670
9/25/2021,Pennsylvania,12802503,338,107012,2689,672
9/26/2021,Pennsylvania,12802503,270,107282,2722,668
9/27/2021,Pennsylvania,12802503,274,107556,2777,688
9/28/2021,Pennsylvania,12802503,351,107907,2806,679
9/29/2021,Pennsylvania,12802503,359,108266,2847,695
9/30/2021,Pennsylvania,12802503,320,108586,2842,702
10/1/2021,Pennsylvania,12802503,351,108937,2822,690
10/2/2021,Pennsylvania,12802503,320,109257,2741,674
10/3/2021,Pennsylvania,12802503,315,109572,2828,686
10/4/2021,Pennsylvania,12802503,297,109869,2890,693
10/5/2021,Pennsylvania,12802503,336,110205,2910,678
10/6/2021,Pennsylvania,12802503,359,110564,2949,700
10/7/2021,Pennsylvania,12802503,361,110925,2961,702
10/8/2021,Pennsylvania,12802503,345,111270,2913,681
10/9/2021,Pennsylvania,12802503,369,111639,2916,698
10/10/2021,Pennsylvania,12802503,308,111947,2926,681
10/11/2021,Pennsylvania,12802503,343,112290,3021,672
10/12/2021,Pennsylvania,12802503,363,112653,3044,688
10/13/2021,Pennsylvania,12802503,382,113035,3028,690
10/14/2021,Pennsylvania,12802503,362,113397,2986,704
10/15/2021,Pennsylvania,12802503,367,113764,2991,698
10/16/2021,Pennsylvania,12802503,360,114124,2907,684
10/17/2021,Pennsylvania,12802503,309,114433,2951,685
10/18/2021,Pennsylvania,12802503,333,114766,3025,715
10/19/2021,Pennsylvania,12802503,357,115123,3022,703
10/20/2021,Pennsylvania,12802503,342,115465,2945,691
10/21/2021,Pennsylvania,12802503,352,115817,2920,679
10/22/2021,Pennsylvania,12802503,352,116169,2885,687
10/23/2021,Pennsylvania,12802503,309,116478,2770,683
10/24/2021,Pennsylvania,12802503,274,116752,2752,677
10/25/2021,Pennsylvania,12802503,294,117046,2832,685
10/26/2021,Pennsylvania,12802503,291,117337,2724,668
10/27/2021,Pennsylvania,12802503,324,117661,2765,667
10/28/2021,Pennsylvania,12802503,286,117947,2739,667
10/29/2021,Pennsylvania,12802503,315,118262,2715,670
10/30/2021,Pennsylvania,12802503,292,118554,2656,656
10/31/2021,Pennsylvania,12802503,272,118826,2640,662
11/1/2021,Pennsylvania,12802503,258,119084,2643,658
11/2/2021,Pennsylvania,12802503,285,119369,2635,648
11/3/2021,Pennsylvania,12802503,302,119671,2589,629
11/4/2021,Pennsylvania,12802503,308,119979,2571,612
11/5/2021,Pennsylvania,12802503,312,120291,2525,574
11/6/2021,Pennsylvania,12802503,270,120561,2482,580
11/7/2021,Pennsylvania,12802503,251,120812,2467,548
11/8/2021,Pennsylvania,12802503,262,121074,2581,578
11/9/2021,Pennsylvania,12802503,278,121352,2569,577
11/10/2021,Pennsylvania,12802503,282,121634,2590,589
11/11/2021,Pennsylvania,12802503,314,121948,2603,606
11/12/2021,Pennsylvania,12802503,293,122241,2563,593
11/13/2021,Pennsylvania,12802503,322,122563,2590,606
11/14/2021,Pennsylvania,12802503,306,122869,2628,611
11/15/2021,Pennsylvania,12802503,290,123159,2822,630
11/16/2021,Pennsylvania,12802503,368,123527,2936,663
11/17/2021,Pennsylvania,12802503,421,123948,3020,703
11/18/2021,Pennsylvania,12802503,418,124366,3125,704
11/19/2021,Pennsylvania,12802503,419,124785,3184,746
11/20/2021,Pennsylvania,12802503,354,125139,3076,746
11/21/2021,Pennsylvania,12802503,368,125507,3116,756
11/22/2021,Pennsylvania,12802503,409,125916,3378,771
11/23/2021,Pennsylvania,12802503,462,126378,3476,783
11/24/2021,Pennsylvania,12802503,467,126845,3536,778
11/25/2021,Pennsylvania,12802503,464,127309,3474,782
11/26/2021,Pennsylvania,12802503,388,127697,3589,820
11/27/2021,Pennsylvania,12802503,486,128183,3667,840
11/28/2021,Pennsylvania,12802503,414,128597,3733,868
11/29/2021,Pennsylvania,12802503,435,129032,3918,886
11/30/2021,Pennsylvania,12802503,527,129559,3984,892
12/1/2021,Pennsylvania,12802503,508,130067,4004,868
12/2/2021,Pennsylvania,12802503,542,130609,4000,886
12/3/2021,Pennsylvania,12802503,555,131164,4102,908
12/4/2021,Pennsylvania,12802503,522,131686,4140,912
12/5/2021,Pennsylvania,12802503,471,132157,4170,909
12/6/2021,Pennsylvania,12802503,486,132643,4342,924
12/7/2021,Pennsylvania,12802503,580,133223,4441,955
12/8/2021,Pennsylvania,12802503,571,133794,4509,966
12/9/2021,Pennsylvania,12802503,584,134378,4580,964
12/10/2021,Pennsylvania,12802503,522,134900,4586,997
12/11/2021,Pennsylvania,12802503,553,135453,4564,976
12/12/2021,Pennsylvania,12802503,514,135967,4619,971
12/13/2021,Pennsylvania,12802503,484,136451,4720,990
12/14/2021,Pennsylvania,12802503,540,136991,4729,1005
12/15/2021,Pennsylvania,12802503,550,137541,4778,1000
12/16/2021,Pennsylvania,12802503,555,138096,4719,980
12/17/2021,Pennsylvania,12802503,538,138634,4632,958
12/18/2021,Pennsylvania,12802503,487,139121,4560,957
12/19/2021,Pennsylvania,12802503,471,139592,4547,970
12/20/2021,Pennsylvania,12802503,436,140028,4651,967
12/21/2021,Pennsylvania,12802503,539,140567,4661,961
12/22/2021,Pennsylvania,12802503,507,141074,4579,967
12/23/2021,Pennsylvania,12802503,522,141596,4519,954
12/24/2021,Pennsylvania,12802503,452,142048,4342,918
12/25/2021,Pennsylvania,12802503,468,142516,4344,901
12/26/2021,Pennsylvania,12802503,514,143030,4466,923
12/27/2021,Pennsylvania,12802503,563,143593,4661,940
12/28/2021,Pennsylvania,12802503,700,144293,4807,930
12/29/2021,Pennsylvania,12802503,723,145016,5074,973
12/30/2021,Pennsylvania,12802503,801,145817,5267,986
12/31/2021,Pennsylvania,12802503,829,146646,5375,986
1/1/2022,Pennsylvania,12802503,699,147345,5482,1011
1/2/2022,Pennsylvania,12802503,732,148077,5865,1042
1/3/2022,Pennsylvania,12802503,829,148906,6066,1052
1/4/2022,Pennsylvania,12802503,909,149815,6300,1082
1/5/2022,Pennsylvania,12802503,882,150697,6489,1081
1/6/2022,Pennsylvania,12802503,951,151648,6723,1092
1/7/2022,Pennsylvania,12802503,993,152641,7176,1112
1/8/2022,Pennsylvania,12802503,934,153575,7008,1096
1/9/2022,Pennsylvania,12802503,763,154338,7043,1113
1/10/2022,Pennsylvania,12802503,863,155201,7220,1134
1/11/2022,Pennsylvania,12802503,994,156195,7608,1171
1/12/2022,Pennsylvania,12802503,1064,157259,7813,1176
1/13/2022,Pennsylvania,12802503,1043,158302,7786,1180
1/14/2022,Pennsylvania,12802503,948,159250,7735,1196
1/15/2022,Pennsylvania,12802503,899,160149,7437,1180
1/16/2022,Pennsylvania,12802503,721,160870,7329,1178
1/17/2022,Pennsylvania,12802503,638,161508,7096,1151
1/18/2022,Pennsylvania,12802503,786,162294,7241,1179
1/19/2022,Pennsylvania,12802503,823,163117,7245,1175
1/20/2022,Pennsylvania,12802503,843,163960,7057,1145
1/21/2022,Pennsylvania,12802503,719,164679,6825,1098
1/22/2022,Pennsylvania,12802503,714,165393,6541,1052
1/23/2022,Pennsylvania,12802503,591,165984,6299,1005
1/24/2022,Pennsylvania,12802503,565,166549,6227,978
1/25/2022,Pennsylvania,12802503,657,167206,6068,937
1/26/2022,Pennsylvania,12802503,637,167843,5780,960
1/27/2022,Pennsylvania,12802503,618,168461,5500,930
1/28/2022,Pennsylvania,12802503,566,169027,5205,862
1/29/2022,Pennsylvania,12802503,534,169561,4921,805
1/30/2022,Pennsylvania,12802503,427,169988,4877,792
1/31/2022,Pennsylvania,12802503,401,170389,4602,770
2/1/2022,Pennsylvania,12802503,497,170886,4495,759
2/2/2022,Pennsylvania,12802503,448,171334,4310,715
2/3/2022,Pennsylvania,12802503,461,171795,4166,671
2/4/2022,Pennsylvania,12802503,423,172218,3830,667
2/5/2022,Pennsylvania,12802503,374,172592,3615,642
2/6/2022,Pennsylvania,12802503,319,172911,3588,623
2/7/2022,Pennsylvania,12802503,315,173226,3465,594
2/8/2022,Pennsylvania,12802503,378,173604,3222,555
2/9/2022,Pennsylvania,12802503,378,173982,3222,555
7/1/2021,Puerto Rico,3285874,5,12316,19,9
7/2/2021,Puerto Rico,3285874,3,12319,19,8
7/3/2021,Puerto Rico,3285874,2,12321,16,8
7/4/2021,Puerto Rico,3285874,2,12323,18,6
7/5/2021,Puerto Rico,3285874,2,12325,16,6
7/6/2021,Puerto Rico,3285874,1,12326,19,6
7/7/2021,Puerto Rico,3285874,2,12328,22,5
7/8/2021,Puerto Rico,3285874,1,12329,14,7
7/9/2021,Puerto Rico,3285874,4,12333,18,8
7/10/2021,Puerto Rico,3285874,4,12337,20,9
7/11/2021,Puerto Rico,3285874,6,12343,22,7
7/12/2021,Puerto Rico,3285874,2,12345,22,6
7/13/2021,Puerto Rico,3285874,2,12347,32,8
7/14/2021,Puerto Rico,3285874,3,12350,36,7
7/15/2021,Puerto Rico,3285874,4,12354,37,8
7/16/2021,Puerto Rico,3285874,6,12360,39,9
7/17/2021,Puerto Rico,3285874,4,12364,38,9
7/18/2021,Puerto Rico,3285874,4,12368,41,8
7/19/2021,Puerto Rico,3285874,3,12371,44,7
7/20/2021,Puerto Rico,3285874,8,12379,43,18
7/21/2021,Puerto Rico,3285874,16,12395,41,17
7/22/2021,Puerto Rico,3285874,16,12411,64,10
7/23/2021,Puerto Rico,3285874,6,12417,65,11
7/24/2021,Puerto Rico,3285874,1,12418,67,11
7/25/2021,Puerto Rico,3285874,6,12424,70,15
7/26/2021,Puerto Rico,3285874,9,12433,70,15
7/27/2021,Puerto Rico,3285874,11,12444,86,15
7/28/2021,Puerto Rico,3285874,13,12457,94,17
7/29/2021,Puerto Rico,3285874,18,12475,97,19
7/30/2021,Puerto Rico,3285874,15,12490,109,20
7/31/2021,Puerto Rico,3285874,21,12511,135,22
8/1/2021,Puerto Rico,3285874,16,12527,142,28
8/2/2021,Puerto Rico,3285874,9,12536,139,27
8/3/2021,Puerto Rico,3285874,18,12554,165,32
8/4/2021,Puerto Rico,3285874,42,12596,186,32
8/5/2021,Puerto Rico,3285874,28,12624,205,38
8/6/2021,Puerto Rico,3285874,30,12654,216,41
8/7/2021,Puerto Rico,3285874,44,12698,245,43
8/8/2021,Puerto Rico,3285874,28,12726,260,50
8/9/2021,Puerto Rico,3285874,21,12747,274,51
8/10/2021,Puerto Rico,3285874,18,12765,284,50
8/11/2021,Puerto Rico,3285874,23,12788,286,56
8/12/2021,Puerto Rico,3285874,25,12813,291,62
8/13/2021,Puerto Rico,3285874,30,12843,318,64
8/14/2021,Puerto Rico,3285874,32,12875,363,68
8/15/2021,Puerto Rico,3285874,29,12904,384,70
8/16/2021,Puerto Rico,3285874,29,12933,390,75
8/17/2021,Puerto Rico,3285874,27,12960,411,81
8/18/2021,Puerto Rico,3285874,34,12994,422,81
8/19/2021,Puerto Rico,3285874,38,13032,418,86
8/20/2021,Puerto Rico,3285874,34,13066,431,90
8/21/2021,Puerto Rico,3285874,44,13110,453,87
8/22/2021,Puerto Rico,3285874,25,13135,459,81
8/23/2021,Puerto Rico,3285874,23,13158,472,80
8/24/2021,Puerto Rico,3285874,22,13180,473,83
8/25/2021,Puerto Rico,3285874,38,13218,458,84
8/26/2021,Puerto Rico,3285874,27,13245,485,84
8/27/2021,Puerto Rico,3285874,37,13282,469,80
8/28/2021,Puerto Rico,3285874,22,13304,432,79
8/29/2021,Puerto Rico,3285874,21,13325,436,82
8/30/2021,Puerto Rico,3285874,13,13338,437,82
8/31/2021,Puerto Rico,3285874,22,13360,463,85
9/1/2021,Puerto Rico,3285874,27,13387,442,76
9/2/2021,Puerto Rico,3285874,26,13413,431,73
9/3/2021,Puerto Rico,3285874,23,13436,430,74
9/4/2021,Puerto Rico,3285874,32,13468,420,79
9/5/2021,Puerto Rico,3285874,21,13489,402,75
9/6/2021,Puerto Rico,3285874,13,13502,399,78
9/7/2021,Puerto Rico,3285874,5,13507,393,80
9/8/2021,Puerto Rico,3285874,16,13523,378,79
9/9/2021,Puerto Rico,3285874,21,13544,342,74
9/10/2021,Puerto Rico,3285874,32,13576,337,74
9/11/2021,Puerto Rico,3285874,27,13603,328,78
9/12/2021,Puerto Rico,3285874,17,13620,330,74
9/13/2021,Puerto Rico,3285874,13,13633,317,78
9/14/2021,Puerto Rico,3285874,22,13655,313,73
9/15/2021,Puerto Rico,3285874,19,13674,293,67
9/16/2021,Puerto Rico,3285874,9,13683,271,61
9/17/2021,Puerto Rico,3285874,16,13699,259,64
9/18/2021,Puerto Rico,3285874,15,13714,248,62
9/19/2021,Puerto Rico,3285874,10,13724,243,60
9/20/2021,Puerto Rico,3285874,12,13736,231,57
9/21/2021,Puerto Rico,3285874,3,13739,215,57
9/22/2021,Puerto Rico,3285874,12,13751,203,57
9/23/2021,Puerto Rico,3285874,8,13759,190,57
9/24/2021,Puerto Rico,3285874,10,13769,194,56
9/25/2021,Puerto Rico,3285874,5,13774,166,46
9/26/2021,Puerto Rico,3285874,4,13778,155,42
9/27/2021,Puerto Rico,3285874,1,13779,157,41
9/28/2021,Puerto Rico,3285874,2,13781,144,36
9/29/2021,Puerto Rico,3285874,8,13789,129,38
9/30/2021,Puerto Rico,3285874,8,13797,130,39
10/1/2021,Puerto Rico,3285874,3,13800,126,37
10/2/2021,Puerto Rico,3285874,5,13805,117,42
10/3/2021,Puerto Rico,3285874,2,13807,108,37
10/4/2021,Puerto Rico,3285874,8,13815,113,37
10/5/2021,Puerto Rico,3285874,5,13820,109,35
10/6/2021,Puerto Rico,3285874,5,13825,101,32
10/7/2021,Puerto Rico,3285874,8,13833,100,29
10/8/2021,Puerto Rico,3285874,5,13838,101,27
10/9/2021,Puerto Rico,3285874,7,13845,98,24
10/10/2021,Puerto Rico,3285874,4,13849,93,27
10/11/2021,Puerto Rico,3285874,4,13853,93,27
10/12/2021,Puerto Rico,3285874,1,13854,92,25
10/13/2021,Puerto Rico,3285874,7,13861,88,26
10/14/2021,Puerto Rico,3285874,8,13869,91,23
10/15/2021,Puerto Rico,3285874,6,13875,100,22
10/16/2021,Puerto Rico,3285874,11,13886,92,20
10/17/2021,Puerto Rico,3285874,0,13886,91,20
10/18/2021,Puerto Rico,3285874,3,13889,86,20
10/19/2021,Puerto Rico,3285874,4,13893,76,18
10/20/2021,Puerto Rico,3285874,6,13899,75,13
10/21/2021,Puerto Rico,3285874,11,13910,69,9
10/22/2021,Puerto Rico,3285874,7,13917,58,6
10/23/2021,Puerto Rico,3285874,3,13920,57,6
10/24/2021,Puerto Rico,3285874,2,13922,50,5
10/25/2021,Puerto Rico,3285874,1,13923,52,5
10/26/2021,Puerto Rico,3285874,2,13925,47,8
10/27/2021,Puerto Rico,3285874,3,13928,44,8
10/28/2021,Puerto Rico,3285874,0,13928,44,8
10/29/2021,Puerto Rico,3285874,4,13932,36,6
10/30/2021,Puerto Rico,3285874,1,13933,37,6
10/31/2021,Puerto Rico,3285874,1,13934,34,7
11/1/2021,Puerto Rico,3285874,5,13939,36,7
11/2/2021,Puerto Rico,3285874,8,13947,36,9
11/3/2021,Puerto Rico,3285874,2,13949,38,9
11/4/2021,Puerto Rico,3285874,4,13953,43,9
11/5/2021,Puerto Rico,3285874,11,13964,43,9
11/6/2021,Puerto Rico,3285874,2,13966,38,10
11/7/2021,Puerto Rico,3285874,1,13967,38,8
11/8/2021,Puerto Rico,3285874,0,13967,35,7
11/9/2021,Puerto Rico,3285874,4,13971,42,8
11/10/2021,Puerto Rico,3285874,4,13975,44,8
11/11/2021,Puerto Rico,3285874,7,13982,45,6
11/12/2021,Puerto Rico,3285874,22,14004,47,4
11/13/2021,Puerto Rico,3285874,17,14021,45,5
11/14/2021,Puerto Rico,3285874,2,14023,50,6
11/15/2021,Puerto Rico,3285874,5,14028,50,6
11/16/2021,Puerto Rico,3285874,6,14034,48,4
11/17/2021,Puerto Rico,3285874,5,14039,43,4
11/18/2021,Puerto Rico,3285874,2,14041,39,4
11/19/2021,Puerto Rico,3285874,1,14042,37,4
11/20/2021,Puerto Rico,3285874,2,14044,36,3
11/21/2021,Puerto Rico,3285874,2,14046,34,4
11/22/2021,Puerto Rico,3285874,5,14051,33,3
11/23/2021,Puerto Rico,3285874,0,14051,33,3
11/24/2021,Puerto Rico,3285874,1,14052,34,3
11/25/2021,Puerto Rico,3285874,4,14056,34,1
11/26/2021,Puerto Rico,3285874,3,14059,31,1
11/27/2021,Puerto Rico,3285874,6,14065,32,0
11/28/2021,Puerto Rico,3285874,0,14065,32,0
11/29/2021,Puerto Rico,3285874,1,14066,33,0
11/30/2021,Puerto Rico,3285874,2,14068,27,1
12/1/2021,Puerto Rico,3285874,3,14071,29,1
12/2/2021,Puerto Rico,3285874,7,14078,31,2
12/3/2021,Puerto Rico,3285874,5,14083,33,3
12/4/2021,Puerto Rico,3285874,3,14086,28,3
12/5/2021,Puerto Rico,3285874,1,14087,28,2
12/6/2021,Puerto Rico,3285874,3,14090,28,2
12/7/2021,Puerto Rico,3285874,5,14095,30,3
12/8/2021,Puerto Rico,3285874,1,14096,27,2
12/9/2021,Puerto Rico,3285874,3,14099,27,4
12/10/2021,Puerto Rico,3285874,6,14105,30,3
12/11/2021,Puerto Rico,3285874,4,14109,28,3
12/12/2021,Puerto Rico,3285874,5,14114,30,2
12/13/2021,Puerto Rico,3285874,4,14118,31,3
12/14/2021,Puerto Rico,3285874,8,14126,34,4
12/15/2021,Puerto Rico,3285874,7,14133,33,6
12/16/2021,Puerto Rico,3285874,5,14138,38,7
12/17/2021,Puerto Rico,3285874,6,14144,40,7
12/18/2021,Puerto Rico,3285874,13,14157,38,8
12/19/2021,Puerto Rico,3285874,7,14164,41,6
12/20/2021,Puerto Rico,3285874,5,14169,41,6
12/21/2021,Puerto Rico,3285874,14,14183,49,7
12/22/2021,Puerto Rico,3285874,17,14200,65,6
12/23/2021,Puerto Rico,3285874,31,14231,88,9
12/24/2021,Puerto Rico,3285874,32,14263,107,6
12/25/2021,Puerto Rico,3285874,35,14298,115,6
12/26/2021,Puerto Rico,3285874,28,14326,129,7
12/27/2021,Puerto Rico,3285874,31,14357,145,8
12/28/2021,Puerto Rico,3285874,55,14412,194,9
12/29/2021,Puerto Rico,3285874,50,14462,236,11
12/30/2021,Puerto Rico,3285874,67,14529,311,19
12/31/2021,Puerto Rico,3285874,96,14625,327,18
1/1/2022,Puerto Rico,3285874,75,14700,347,30
1/2/2022,Puerto Rico,3285874,40,14740,318,30
1/3/2022,Puerto Rico,3285874,41,14781,331,32
1/4/2022,Puerto Rico,3285874,89,14870,416,37
1/5/2022,Puerto Rico,3285874,71,14941,451,43
1/6/2022,Puerto Rico,3285874,100,15041,575,49
1/7/2022,Puerto Rico,3285874,107,15148,598,48
1/8/2022,Puerto Rico,3285874,125,15273,654,47
1/9/2022,Puerto Rico,3285874,107,15380,666,48
1/10/2022,Puerto Rico,3285874,72,15452,670,53
1/11/2022,Puerto Rico,3285874,91,15543,638,54
1/12/2022,Puerto Rico,3285874,81,15624,703,72
1/13/2022,Puerto Rico,3285874,198,15822,691,78
1/14/2022,Puerto Rico,3285874,175,15997,742,93
1/15/2022,Puerto Rico,3285874,153,16150,776,94
1/16/2022,Puerto Rico,3285874,149,16299,776,99
1/17/2022,Puerto Rico,3285874,102,16401,754,90
1/18/2022,Puerto Rico,3285874,68,16469,829,100
1/19/2022,Puerto Rico,3285874,72,16541,799,107
1/20/2022,Puerto Rico,3285874,102,16643,803,107
1/21/2022,Puerto Rico,3285874,119,16762,779,94
1/22/2022,Puerto Rico,3285874,100,16862,752,100
1/23/2022,Puerto Rico,3285874,50,16912,715,96
1/24/2022,Puerto Rico,3285874,68,16980,680,88
1/25/2022,Puerto Rico,3285874,48,17028,650,82
1/26/2022,Puerto Rico,3285874,51,17079,625,93
1/27/2022,Puerto Rico,3285874,61,17140,599,98
1/28/2022,Puerto Rico,3285874,44,17184,556,89
1/29/2022,Puerto Rico,3285874,36,17220,522,92
1/30/2022,Puerto Rico,3285874,63,17283,480,78
1/31/2022,Puerto Rico,3285874,18,17301,460,78
2/1/2022,Puerto Rico,3285874,26,17327,428,78
2/2/2022,Puerto Rico,3285874,26,17353,438,69
2/3/2022,Puerto Rico,3285874,28,17381,415,78
2/4/2022,Puerto Rico,3285874,23,17404,349,65
2/5/2022,Puerto Rico,3285874,28,17432,326,59
2/6/2022,Puerto Rico,3285874,12,17444,288,56
2/7/2022,Puerto Rico,3285874,12,17456,277,58
2/8/2022,Puerto Rico,3285874,11,17467,278,58
2/9/2022,Puerto Rico,3285874,11,17478,278,58
7/1/2021,Rhode Island,1056298,1,4732,30,3
7/2/2021,Rhode Island,1056298,1,4733,30,3
7/3/2021,Rhode Island,1056298,2,4735,32,4
7/4/2021,Rhode Island,1056298,0,4735,30,3
7/5/2021,Rhode Island,1056298,0,4735,30,4
7/6/2021,Rhode Island,1056298,2,4737,30,4
7/7/2021,Rhode Island,1056298,1,4738,37,4
7/8/2021,Rhode Island,1056298,6,4744,42,3
7/9/2021,Rhode Island,1056298,3,4747,40,3
7/10/2021,Rhode Island,1056298,0,4747,37,3
7/11/2021,Rhode Island,1056298,0,4747,32,3
7/12/2021,Rhode Island,1056298,1,4748,31,4
7/13/2021,Rhode Island,1056298,0,4748,32,3
7/14/2021,Rhode Island,1056298,3,4751,31,4
7/15/2021,Rhode Island,1056298,0,4751,29,3
7/16/2021,Rhode Island,1056298,4,4755,29,3
7/17/2021,Rhode Island,1056298,0,4755,31,3
7/18/2021,Rhode Island,1056298,1,4756,31,4
7/19/2021,Rhode Island,1056298,2,4758,32,4
7/20/2021,Rhode Island,1056298,0,4758,31,4
7/21/2021,Rhode Island,1056298,1,4759,30,4
7/22/2021,Rhode Island,1056298,2,4761,28,4
7/23/2021,Rhode Island,1056298,5,4766,35,4
7/24/2021,Rhode Island,1056298,3,4769,36,4
7/25/2021,Rhode Island,1056298,2,4771,34,4
7/26/2021,Rhode Island,1056298,2,4773,36,4
7/27/2021,Rhode Island,1056298,5,4778,25,4
7/28/2021,Rhode Island,1056298,3,4781,30,5
7/29/2021,Rhode Island,1056298,4,4785,29,6
7/30/2021,Rhode Island,1056298,2,4787,27,6
7/31/2021,Rhode Island,1056298,1,4788,27,5
8/1/2021,Rhode Island,1056298,1,4789,25,5
8/2/2021,Rhode Island,1056298,4,4793,26,6
8/3/2021,Rhode Island,1056298,6,4799,36,7
8/4/2021,Rhode Island,1056298,4,4803,41,8
8/5/2021,Rhode Island,1056298,7,4810,45,9
8/6/2021,Rhode Island,1056298,6,4816,50,11
8/7/2021,Rhode Island,1056298,10,4826,57,8
8/8/2021,Rhode Island,1056298,6,4832,55,7
8/9/2021,Rhode Island,1056298,9,4841,57,8
8/10/2021,Rhode Island,1056298,18,4859,86,12
8/11/2021,Rhode Island,1056298,11,4870,82,13
8/12/2021,Rhode Island,1056298,9,4879,72,11
8/13/2021,Rhode Island,1056298,6,4885,77,15
8/14/2021,Rhode Island,1056298,17,4902,85,12
8/15/2021,Rhode Island,1056298,21,4923,84,13
8/16/2021,Rhode Island,1056298,9,4932,90,14
8/17/2021,Rhode Island,1056298,13,4945,108,18
8/18/2021,Rhode Island,1056298,11,4956,98,19
8/19/2021,Rhode Island,1056298,14,4970,93,15
8/20/2021,Rhode Island,1056298,16,4986,101,18
8/21/2021,Rhode Island,1056298,13,4999,102,19
8/22/2021,Rhode Island,1056298,13,5012,107,18
8/23/2021,Rhode Island,1056298,10,5022,116,24
8/24/2021,Rhode Island,1056298,10,5032,121,25
8/25/2021,Rhode Island,1056298,9,5041,121,25
8/26/2021,Rhode Island,1056298,12,5053,119,25
8/27/2021,Rhode Island,1056298,15,5068,118,22
8/28/2021,Rhode Island,1056298,11,5079,119,21
8/29/2021,Rhode Island,1056298,13,5092,121,21
8/30/2021,Rhode Island,1056298,10,5102,127,22
8/31/2021,Rhode Island,1056298,13,5115,124,22
9/1/2021,Rhode Island,1056298,17,5132,135,19
9/2/2021,Rhode Island,1056298,12,5144,138,16
9/3/2021,Rhode Island,1056298,17,5161,135,16
9/4/2021,Rhode Island,1056298,18,5179,138,25
9/5/2021,Rhode Island,1056298,9,5188,137,23
9/6/2021,Rhode Island,1056298,6,5194,137,23
9/7/2021,Rhode Island,1056298,6,5200,129,12
9/8/2021,Rhode Island,1056298,13,5213,118,10
9/9/2021,Rhode Island,1056298,8,5221,111,17
9/10/2021,Rhode Island,1056298,13,5234,112,16
9/11/2021,Rhode Island,1056298,8,5242,96,17
9/12/2021,Rhode Island,1056298,6,5248,89,15
9/13/2021,Rhode Island,1056298,13,5261,93,17
9/14/2021,Rhode Island,1056298,15,5276,95,19
9/15/2021,Rhode Island,1056298,14,5290,99,22
9/16/2021,Rhode Island,1056298,13,5303,101,25
9/17/2021,Rhode Island,1056298,4,5307,89,22
9/18/2021,Rhode Island,1056298,13,5320,92,23
9/19/2021,Rhode Island,1056298,11,5331,98,22
9/20/2021,Rhode Island,1056298,9,5340,99,21
9/21/2021,Rhode Island,1056298,18,5358,104,19
9/22/2021,Rhode Island,1056298,13,5371,105,16
9/23/2021,Rhode Island,1056298,11,5382,103,12
9/24/2021,Rhode Island,1056298,13,5395,107,14
9/25/2021,Rhode Island,1056298,13,5408,110,13
9/26/2021,Rhode Island,1056298,15,5423,114,13
9/27/2021,Rhode Island,1056298,9,5432,109,13
9/28/2021,Rhode Island,1056298,4,5436,103,11
9/29/2021,Rhode Island,1056298,13,5449,101,13
9/30/2021,Rhode Island,1056298,5,5454,93,12
10/1/2021,Rhode Island,1056298,15,5469,99,13
10/2/2021,Rhode Island,1056298,11,5480,89,16
10/3/2021,Rhode Island,1056298,5,5485,89,16
10/4/2021,Rhode Island,1056298,3,5488,80,13
10/5/2021,Rhode Island,1056298,14,5502,82,15
10/6/2021,Rhode Island,1056298,14,5516,78,12
10/7/2021,Rhode Island,1056298,7,5523,70,12
10/8/2021,Rhode Island,1056298,7,5530,73,11
10/9/2021,Rhode Island,1056298,8,5538,68,10
10/10/2021,Rhode Island,1056298,6,5544,66,12
10/11/2021,Rhode Island,1056298,6,5550,69,11
10/12/2021,Rhode Island,1056298,6,5556,78,11
10/13/2021,Rhode Island,1056298,12,5568,84,13
10/14/2021,Rhode Island,1056298,7,5575,81,17
10/15/2021,Rhode Island,1056298,13,5588,83,17
10/16/2021,Rhode Island,1056298,5,5593,93,19
10/17/2021,Rhode Island,1056298,3,5596,91,19
10/18/2021,Rhode Island,1056298,13,5609,97,20
10/19/2021,Rhode Island,1056298,12,5621,95,15
10/20/2021,Rhode Island,1056298,4,5625,86,13
10/21/2021,Rhode Island,1056298,9,5634,88,13
10/22/2021,Rhode Island,1056298,12,5646,92,14
10/23/2021,Rhode Island,1056298,8,5654,88,16
10/24/2021,Rhode Island,1056298,4,5658,81,17
10/25/2021,Rhode Island,1056298,5,5663,81,15
10/26/2021,Rhode Island,1056298,3,5666,73,10
10/27/2021,Rhode Island,1056298,12,5678,71,7
10/28/2021,Rhode Island,1056298,6,5684,69,8
10/29/2021,Rhode Island,1056298,9,5693,68,7
10/30/2021,Rhode Island,1056298,5,5698,64,8
10/31/2021,Rhode Island,1056298,4,5702,60,9
11/1/2021,Rhode Island,1056298,6,5708,65,8
11/2/2021,Rhode Island,1056298,8,5716,68,8
11/3/2021,Rhode Island,1056298,16,5732,80,11
11/4/2021,Rhode Island,1056298,11,5743,78,14
11/5/2021,Rhode Island,1056298,11,5754,81,12
11/6/2021,Rhode Island,1056298,10,5764,77,13
11/7/2021,Rhode Island,1056298,7,5771,78,12
11/8/2021,Rhode Island,1056298,5,5776,90,11
11/9/2021,Rhode Island,1056298,9,5785,85,15
11/10/2021,Rhode Island,1056298,11,5796,84,13
11/11/2021,Rhode Island,1056298,12,5808,89,11
11/12/2021,Rhode Island,1056298,11,5819,88,13
11/13/2021,Rhode Island,1056298,8,5827,85,15
11/14/2021,Rhode Island,1056298,10,5837,91,18
11/15/2021,Rhode Island,1056298,6,5843,92,23
11/16/2021,Rhode Island,1056298,15,5858,88,21
11/17/2021,Rhode Island,1056298,10,5868,89,22
11/18/2021,Rhode Island,1056298,10,5878,95,20
11/19/2021,Rhode Island,1056298,10,5888,97,17
11/20/2021,Rhode Island,1056298,19,5907,99,20
11/21/2021,Rhode Island,1056298,8,5915,98,22
11/22/2021,Rhode Island,1056298,9,5924,101,21
11/23/2021,Rhode Island,1056298,22,5946,119,25
11/24/2021,Rhode Island,1056298,15,5961,119,21
11/25/2021,Rhode Island,1056298,11,5972,121,24
11/26/2021,Rhode Island,1056298,15,5987,127,28
11/27/2021,Rhode Island,1056298,12,5999,143,28
11/28/2021,Rhode Island,1056298,13,6012,139,26
11/29/2021,Rhode Island,1056298,14,6026,149,25
11/30/2021,Rhode Island,1056298,15,6041,143,18
12/1/2021,Rhode Island,1056298,23,6064,150,19
12/2/2021,Rhode Island,1056298,21,6085,154,20
12/3/2021,Rhode Island,1056298,21,6106,158,18
12/4/2021,Rhode Island,1056298,16,6122,165,25
12/5/2021,Rhode Island,1056298,14,6136,170,27
12/6/2021,Rhode Island,1056298,21,6157,196,29
12/7/2021,Rhode Island,1056298,32,6189,210,35
12/8/2021,Rhode Island,1056298,28,6217,212,36
12/9/2021,Rhode Island,1056298,24,6241,202,37
12/10/2021,Rhode Island,1056298,28,6269,208,36
12/11/2021,Rhode Island,1056298,29,6298,197,34
12/12/2021,Rhode Island,1056298,31,6329,226,33
12/13/2021,Rhode Island,1056298,33,6362,256,38
12/14/2021,Rhode Island,1056298,32,6394,259,44
12/15/2021,Rhode Island,1056298,32,6426,262,38
12/16/2021,Rhode Island,1056298,21,6447,233,37
12/17/2021,Rhode Island,1056298,39,6486,252,35
12/18/2021,Rhode Island,1056298,30,6516,247,37
12/19/2021,Rhode Island,1056298,20,6536,247,39
12/20/2021,Rhode Island,1056298,22,6558,248,38
12/21/2021,Rhode Island,1056298,26,6584,239,40
12/22/2021,Rhode Island,1056298,37,6621,249,47
12/23/2021,Rhode Island,1056298,23,6644,257,51
12/24/2021,Rhode Island,1056298,34,6678,256,42
12/25/2021,Rhode Island,1056298,19,6697,255,40
12/26/2021,Rhode Island,1056298,11,6708,246,37
12/27/2021,Rhode Island,1056298,28,6736,272,46
12/28/2021,Rhode Island,1056298,36,6772,269,46
12/29/2021,Rhode Island,1056298,47,6819,297,48
12/30/2021,Rhode Island,1056298,56,6875,311,47
12/31/2021,Rhode Island,1056298,52,6927,314,49
1/1/2022,Rhode Island,1056298,47,6974,315,49
1/2/2022,Rhode Island,1056298,40,7014,340,50
1/3/2022,Rhode Island,1056298,44,7058,351,47
1/4/2022,Rhode Island,1056298,61,7119,364,47
1/5/2022,Rhode Island,1056298,58,7177,385,47
1/6/2022,Rhode Island,1056298,54,7231,416,52
1/7/2022,Rhode Island,1056298,55,7286,427,53
1/8/2022,Rhode Island,1056298,62,7348,472,56
1/9/2022,Rhode Island,1056298,30,7378,433,51
1/10/2022,Rhode Island,1056298,40,7418,450,54
1/11/2022,Rhode Island,1056298,65,7483,482,54
1/12/2022,Rhode Island,1056298,77,7560,494,56
1/13/2022,Rhode Island,1056298,79,7639,539,53
1/14/2022,Rhode Island,1056298,82,7721,543,47
1/15/2022,Rhode Island,1056298,65,7786,518,45
1/16/2022,Rhode Island,1056298,43,7829,503,42
1/17/2022,Rhode Island,1056298,31,7860,494,42
1/18/2022,Rhode Island,1056298,64,7924,519,53
1/19/2022,Rhode Island,1056298,63,7987,494,49
1/20/2022,Rhode Island,1056298,50,8037,445,46
1/21/2022,Rhode Island,1056298,38,8075,416,39
1/22/2022,Rhode Island,1056298,50,8125,406,37
1/23/2022,Rhode Island,1056298,37,8162,409,38
1/24/2022,Rhode Island,1056298,41,8203,391,35
1/25/2022,Rhode Island,1056298,43,8246,381,43
1/26/2022,Rhode Island,1056298,33,8279,364,40
1/27/2022,Rhode Island,1056298,44,8323,326,40
1/28/2022,Rhode Island,1056298,35,8358,312,41
1/29/2022,Rhode Island,1056298,32,8390,272,38
1/30/2022,Rhode Island,1056298,19,8409,286,34
1/31/2022,Rhode Island,1056298,13,8422,265,31
2/1/2022,Rhode Island,1056298,30,8452,259,30
2/2/2022,Rhode Island,1056298,23,8475,237,28
2/3/2022,Rhode Island,1056298,31,8506,229,41
2/4/2022,Rhode Island,1056298,27,8533,221,30
2/5/2022,Rhode Island,1056298,19,8552,209,32
2/6/2022,Rhode Island,1056298,9,8561,183,29
2/7/2022,Rhode Island,1056298,17,8578,188,26
2/8/2022,Rhode Island,1056298,17,8595,158,23
2/9/2022,Rhode Island,1056298,17,8612,158,23
7/1/2021,South Carolina,4896146,8,34876,87,19
7/2/2021,South Carolina,4896146,19,34895,89,25
7/3/2021,South Carolina,4896146,18,34913,95,32
7/4/2021,South Carolina,4896146,9,34922,96,30
7/5/2021,South Carolina,4896146,23,34945,100,31
7/6/2021,South Carolina,4896146,15,34960,112,34
7/7/2021,South Carolina,4896146,27,34987,124,36
7/8/2021,South Carolina,4896146,23,35010,131,32
7/9/2021,South Carolina,4896146,32,35042,139,31
7/10/2021,South Carolina,4896146,21,35063,139,36
7/11/2021,South Carolina,4896146,32,35095,154,37
7/12/2021,South Carolina,4896146,29,35124,167,42
7/13/2021,South Carolina,4896146,36,35160,175,40
7/14/2021,South Carolina,4896146,37,35197,183,46
7/15/2021,South Carolina,4896146,30,35227,198,48
7/16/2021,South Carolina,4896146,42,35269,206,50
7/17/2021,South Carolina,4896146,41,35310,223,62
7/18/2021,South Carolina,4896146,49,35359,262,68
7/19/2021,South Carolina,4896146,48,35407,287,79
7/20/2021,South Carolina,4896146,43,35450,290,83
7/21/2021,South Carolina,4896146,52,35502,306,92
7/22/2021,South Carolina,4896146,55,35557,325,102
7/23/2021,South Carolina,4896146,49,35606,341,100
7/24/2021,South Carolina,4896146,58,35664,354,109
7/25/2021,South Carolina,4896146,66,35730,396,118
7/26/2021,South Carolina,4896146,92,35822,431,133
7/27/2021,South Carolina,4896146,82,35904,489,144
7/28/2021,South Carolina,4896146,98,36002,548,158
7/29/2021,South Carolina,4896146,114,36116,611,174
7/30/2021,South Carolina,4896146,135,36251,660,184
7/31/2021,South Carolina,4896146,138,36389,691,187
8/1/2021,South Carolina,4896146,121,36510,766,207
8/2/2021,South Carolina,4896146,145,36655,855,239
8/3/2021,South Carolina,4896146,144,36799,894,242
8/4/2021,South Carolina,4896146,150,36949,931,247
8/5/2021,South Carolina,4896146,159,37108,1005,262
8/6/2021,South Carolina,4896146,168,37276,1060,280
8/7/2021,South Carolina,4896146,190,37466,1081,299
8/8/2021,South Carolina,4896146,173,37639,1199,330
8/9/2021,South Carolina,4896146,177,37816,1234,335
8/10/2021,South Carolina,4896146,179,37995,1288,334
8/11/2021,South Carolina,4896146,214,38209,1370,352
8/12/2021,South Carolina,4896146,209,38418,1400,353
8/13/2021,South Carolina,4896146,219,38637,1451,381
8/14/2021,South Carolina,4896146,222,38859,1506,398
8/15/2021,South Carolina,4896146,249,39108,1613,413
8/16/2021,South Carolina,4896146,232,39340,1697,438
8/17/2021,South Carolina,4896146,268,39608,1717,438
8/18/2021,South Carolina,4896146,294,39902,1882,481
8/19/2021,South Carolina,4896146,272,40174,1911,507
8/20/2021,South Carolina,4896146,261,40435,1900,495
8/21/2021,South Carolina,4896146,291,40726,1912,473
8/22/2021,South Carolina,4896146,295,41021,2015,509
8/23/2021,South Carolina,4896146,253,41274,2053,522
8/24/2021,South Carolina,4896146,327,41601,2113,509
8/25/2021,South Carolina,4896146,325,41926,2150,518
8/26/2021,South Carolina,4896146,347,42273,2158,518
8/27/2021,South Carolina,4896146,302,42575,2203,528
8/28/2021,South Carolina,4896146,295,42870,2220,546
8/29/2021,South Carolina,4896146,278,43148,2232,543
8/30/2021,South Carolina,4896146,300,43448,2249,545
8/31/2021,South Carolina,4896146,319,43767,2323,537
9/1/2021,South Carolina,4896146,352,44119,2397,559
9/2/2021,South Carolina,4896146,345,44464,2418,553
9/3/2021,South Carolina,4896146,284,44748,2429,553
9/4/2021,South Carolina,4896146,335,45083,2423,556
9/5/2021,South Carolina,4896146,304,45387,2488,561
9/6/2021,South Carolina,4896146,347,45734,2534,588
9/7/2021,South Carolina,4896146,342,46076,2565,582
9/8/2021,South Carolina,4896146,334,46410,2527,581
9/9/2021,South Carolina,4896146,358,46768,2531,592
9/10/2021,South Carolina,4896146,340,47108,2551,610
9/11/2021,South Carolina,4896146,310,47418,2462,592
9/12/2021,South Carolina,4896146,294,47712,2521,602
9/13/2021,South Carolina,4896146,304,48016,2568,626
9/14/2021,South Carolina,4896146,315,48331,2550,605
9/15/2021,South Carolina,4896146,289,48620,2495,601
9/16/2021,South Carolina,4896146,306,48926,2466,591
9/17/2021,South Carolina,4896146,278,49204,2415,582
9/18/2021,South Carolina,4896146,270,49474,2363,591
9/19/2021,South Carolina,4896146,225,49699,2348,594
9/20/2021,South Carolina,4896146,238,49937,2290,588
9/21/2021,South Carolina,4896146,247,50184,2302,583
9/22/2021,South Carolina,4896146,239,50423,2233,546
9/23/2021,South Carolina,4896146,227,50650,2186,532
9/24/2021,South Carolina,4896146,193,50843,2100,534
9/25/2021,South Carolina,4896146,179,51022,2052,562
9/26/2021,South Carolina,4896146,162,51184,1996,545
9/27/2021,South Carolina,4896146,165,51349,1961,514
9/28/2021,South Carolina,4896146,171,51520,1851,497
9/29/2021,South Carolina,4896146,185,51705,1788,490
9/30/2021,South Carolina,4896146,175,51880,1685,485
10/1/2021,South Carolina,4896146,172,52052,1608,464
10/2/2021,South Carolina,4896146,141,52193,1603,466
10/3/2021,South Carolina,4896146,142,52335,1614,460
10/4/2021,South Carolina,4896146,122,52457,1569,446
10/5/2021,South Carolina,4896146,138,52595,1496,437
10/6/2021,South Carolina,4896146,130,52725,1429,411
10/7/2021,South Carolina,4896146,138,52863,1362,403
10/8/2021,South Carolina,4896146,140,53003,1311,391
10/9/2021,South Carolina,4896146,120,53123,1272,378
10/10/2021,South Carolina,4896146,94,53217,1245,372
10/11/2021,South Carolina,4896146,102,53319,1225,336
10/12/2021,South Carolina,4896146,116,53435,1178,348
10/13/2021,South Carolina,4896146,88,53523,1116,340
10/14/2021,South Carolina,4896146,87,53610,1060,328
10/15/2021,South Carolina,4896146,97,53707,1024,316
10/16/2021,South Carolina,4896146,100,53807,965,311
10/17/2021,South Carolina,4896146,88,53895,958,307
10/18/2021,South Carolina,4896146,72,53967,919,291
10/19/2021,South Carolina,4896146,84,54051,888,282
10/20/2021,South Carolina,4896146,72,54123,853,271
10/21/2021,South Carolina,4896146,81,54204,802,253
10/22/2021,South Carolina,4896146,68,54272,756,235
10/23/2021,South Carolina,4896146,62,54334,732,235
10/24/2021,South Carolina,4896146,46,54380,706,224
10/25/2021,South Carolina,4896146,61,54441,699,212
10/26/2021,South Carolina,4896146,69,54510,686,214
10/27/2021,South Carolina,4896146,56,54566,658,208
10/28/2021,South Carolina,4896146,74,54640,641,194
10/29/2021,South Carolina,4896146,51,54691,617,191
10/30/2021,South Carolina,4896146,59,54750,588,184
10/31/2021,South Carolina,4896146,50,54800,579,176
11/1/2021,South Carolina,4896146,39,54839,557,174
11/2/2021,South Carolina,4896146,56,54895,535,159
11/3/2021,South Carolina,4896146,56,54951,516,149
11/4/2021,South Carolina,4896146,47,54998,489,133
11/5/2021,South Carolina,4896146,67,55065,469,140
11/6/2021,South Carolina,4896146,54,55119,483,144
11/7/2021,South Carolina,4896146,34,55153,472,143
11/8/2021,South Carolina,4896146,49,55202,467,145
11/9/2021,South Carolina,4896146,57,55259,466,141
11/10/2021,South Carolina,4896146,53,55312,450,126
11/11/2021,South Carolina,4896146,43,55355,424,126
11/12/2021,South Carolina,4896146,40,55395,416,129
11/13/2021,South Carolina,4896146,59,55454,439,122
11/14/2021,South Carolina,4896146,47,55501,436,119
11/15/2021,South Carolina,4896146,44,55545,426,119
11/16/2021,South Carolina,4896146,58,55603,433,116
11/17/2021,South Carolina,4896146,56,55659,418,125
11/18/2021,South Carolina,4896146,50,55709,413,125
11/19/2021,South Carolina,4896146,53,55762,402,120
11/20/2021,South Carolina,4896146,51,55813,396,126
11/21/2021,South Carolina,4896146,45,55858,395,125
11/22/2021,South Carolina,4896146,43,55901,390,115
11/23/2021,South Carolina,4896146,45,55946,386,124
11/24/2021,South Carolina,4896146,45,55991,359,111
11/25/2021,South Carolina,4896146,46,56037,386,116
11/26/2021,South Carolina,4896146,54,56091,395,109
11/27/2021,South Carolina,4896146,47,56138,389,107
11/28/2021,South Carolina,4896146,37,56175,384,103
11/29/2021,South Carolina,4896146,55,56230,405,112
11/30/2021,South Carolina,4896146,69,56299,406,113
12/1/2021,South Carolina,4896146,61,56360,411,121
12/2/2021,South Carolina,4896146,59,56419,398,121
12/3/2021,South Carolina,4896146,62,56481,405,123
12/4/2021,South Carolina,4896146,48,56529,404,128
12/5/2021,South Carolina,4896146,53,56582,422,133
12/6/2021,South Carolina,4896146,56,56638,434,128
12/7/2021,South Carolina,4896146,62,56700,448,129
12/8/2021,South Carolina,4896146,63,56763,446,131
12/9/2021,South Carolina,4896146,73,56836,471,133
12/10/2021,South Carolina,4896146,66,56902,477,133
12/11/2021,South Carolina,4896146,54,56956,475,140
12/12/2021,South Carolina,4896146,76,57032,505,153
12/13/2021,South Carolina,4896146,67,57099,540,148
12/14/2021,South Carolina,4896146,84,57183,552,149
12/15/2021,South Carolina,4896146,79,57262,545,148
12/16/2021,South Carolina,4896146,70,57332,556,158
12/17/2021,South Carolina,4896146,52,57384,523,157
12/18/2021,South Carolina,4896146,62,57446,508,164
12/19/2021,South Carolina,4896146,59,57505,521,161
12/20/2021,South Carolina,4896146,73,57578,509,155
12/21/2021,South Carolina,4896146,73,57651,538,164
12/22/2021,South Carolina,4896146,90,57741,584,166
12/23/2021,South Carolina,4896146,90,57831,586,160
12/24/2021,South Carolina,4896146,101,57932,592,173
12/25/2021,South Carolina,4896146,94,58026,604,172
12/26/2021,South Carolina,4896146,103,58129,646,164
12/27/2021,South Carolina,4896146,141,58270,748,176
12/28/2021,South Carolina,4896146,145,58415,780,181
12/29/2021,South Carolina,4896146,160,58575,851,194
12/30/2021,South Carolina,4896146,197,58772,950,199
12/31/2021,South Carolina,4896146,222,58994,1031,215
1/1/2022,South Carolina,4896146,201,59195,1134,229
1/2/2022,South Carolina,4896146,232,59427,1235,241
1/3/2022,South Carolina,4896146,253,59680,1270,265
1/4/2022,South Carolina,4896146,251,59931,1376,272
1/5/2022,South Carolina,4896146,285,60216,1472,275
1/6/2022,South Carolina,4896146,280,60496,1544,280
1/7/2022,South Carolina,4896146,319,60815,1617,291
1/8/2022,South Carolina,4896146,313,61128,1710,323
1/9/2022,South Carolina,4896146,273,61401,1765,326
1/10/2022,South Carolina,4896146,305,61706,1905,330
1/11/2022,South Carolina,4896146,374,62080,1998,347
1/12/2022,South Carolina,4896146,396,62476,2104,365
1/13/2022,South Carolina,4896146,380,62856,2160,368
1/14/2022,South Carolina,4896146,391,63247,2183,380
1/15/2022,South Carolina,4896146,369,63616,2211,388
1/16/2022,South Carolina,4896146,355,63971,2290,417
1/17/2022,South Carolina,4896146,337,64308,2323,421
1/18/2022,South Carolina,4896146,404,64712,2377,396
1/19/2022,South Carolina,4896146,438,65150,2488,423
1/20/2022,South Carolina,4896146,444,65594,2540,436
1/21/2022,South Carolina,4896146,427,66021,2523,429
1/22/2022,South Carolina,4896146,365,66386,2504,426
1/23/2022,South Carolina,4896146,334,66720,2509,427
1/24/2022,South Carolina,4896146,394,67114,2573,446
1/25/2022,South Carolina,4896146,490,67604,2563,439
1/26/2022,South Carolina,4896146,438,68042,2651,443
1/27/2022,South Carolina,4896146,390,68432,2561,441
1/28/2022,South Carolina,4896146,345,68777,2498,447
1/29/2022,South Carolina,4896146,377,69154,2443,451
1/30/2022,South Carolina,4896146,285,69439,2473,464
1/31/2022,South Carolina,4896146,255,69694,2408,433
2/1/2022,South Carolina,4896146,313,70007,2341,427
2/2/2022,South Carolina,4896146,319,70326,2307,428
2/3/2022,South Carolina,4896146,257,70583,2185,424
2/4/2022,South Carolina,4896146,276,70859,2051,384
2/5/2022,South Carolina,4896146,212,71071,1954,401
2/6/2022,South Carolina,4896146,204,71275,1915,384
2/7/2022,South Carolina,4896146,200,71475,1851,371
2/8/2022,South Carolina,4896146,216,71691,1794,374
2/9/2022,South Carolina,4896146,228,71919,1795,371
7/1/2021,South Dakota,858469,6,7858,15,4
7/2/2021,South Dakota,858469,4,7862,10,5
7/3/2021,South Dakota,858469,3,7865,8,4
7/4/2021,South Dakota,858469,3,7868,10,3
7/5/2021,South Dakota,858469,3,7871,8,2
7/6/2021,South Dakota,858469,3,7874,8,2
7/7/2021,South Dakota,858469,5,7879,11,3
7/8/2021,South Dakota,858469,3,7882,10,3
7/9/2021,South Dakota,858469,5,7887,13,4
7/10/2021,South Dakota,858469,6,7893,12,7
7/11/2021,South Dakota,858469,3,7896,9,7
7/12/2021,South Dakota,858469,3,7899,8,7
7/13/2021,South Dakota,858469,6,7905,9,8
7/14/2021,South Dakota,858469,6,7911,14,8
7/15/2021,South Dakota,858469,7,7918,15,6
7/16/2021,South Dakota,858469,7,7925,18,6
7/17/2021,South Dakota,858469,9,7934,24,7
7/18/2021,South Dakota,858469,5,7939,22,8
7/19/2021,South Dakota,858469,2,7941,21,9
7/20/2021,South Dakota,858469,5,7946,23,9
7/21/2021,South Dakota,858469,5,7951,21,8
7/22/2021,South Dakota,858469,2,7953,18,10
7/23/2021,South Dakota,858469,5,7958,20,10
7/24/2021,South Dakota,858469,5,7963,21,9
7/25/2021,South Dakota,858469,3,7966,19,10
7/26/2021,South Dakota,858469,4,7970,23,10
7/27/2021,South Dakota,858469,8,7978,25,9
7/28/2021,South Dakota,858469,6,7984,25,10
7/29/2021,South Dakota,858469,7,7991,27,9
7/30/2021,South Dakota,858469,4,7995,23,9
7/31/2021,South Dakota,858469,9,8004,28,8
8/1/2021,South Dakota,858469,6,8010,34,11
8/2/2021,South Dakota,858469,6,8016,37,13
8/3/2021,South Dakota,858469,9,8025,33,12
8/4/2021,South Dakota,858469,5,8030,35,12
8/5/2021,South Dakota,858469,9,8039,33,13
8/6/2021,South Dakota,858469,9,8048,42,16
8/7/2021,South Dakota,858469,8,8056,44,14
8/8/2021,South Dakota,858469,8,8064,44,12
8/9/2021,South Dakota,858469,15,8079,56,17
8/10/2021,South Dakota,858469,17,8096,62,16
8/11/2021,South Dakota,858469,12,8108,64,18
8/12/2021,South Dakota,858469,11,8119,64,21
8/13/2021,South Dakota,858469,15,8134,65,22
8/14/2021,South Dakota,858469,21,8155,74,26
8/15/2021,South Dakota,858469,3,8158,80,28
8/16/2021,South Dakota,858469,15,8173,85,27
8/17/2021,South Dakota,858469,15,8188,92,32
8/18/2021,South Dakota,858469,23,8211,104,33
8/19/2021,South Dakota,858469,18,8229,106,35
8/20/2021,South Dakota,858469,19,8248,108,36
8/21/2021,South Dakota,858469,19,8267,109,37
8/22/2021,South Dakota,858469,17,8284,109,33
8/23/2021,South Dakota,858469,37,8321,127,38
8/24/2021,South Dakota,858469,34,8355,138,37
8/25/2021,South Dakota,858469,33,8388,141,38
8/26/2021,South Dakota,858469,33,8421,154,40
8/27/2021,South Dakota,858469,30,8451,157,50
8/28/2021,South Dakota,858469,38,8489,159,51
8/29/2021,South Dakota,858469,36,8525,180,51
8/30/2021,South Dakota,858469,32,8557,197,55
8/31/2021,South Dakota,858469,32,8589,199,77
9/1/2021,South Dakota,858469,29,8618,201,59
9/2/2021,South Dakota,858469,41,8659,221,66
9/3/2021,South Dakota,858469,30,8689,223,67
9/4/2021,South Dakota,858469,42,8731,200,59
9/5/2021,South Dakota,858469,23,8754,222,63
9/6/2021,South Dakota,858469,20,8774,209,63
9/7/2021,South Dakota,858469,16,8790,203,72
9/8/2021,South Dakota,858469,26,8816,200,61
9/9/2021,South Dakota,858469,29,8845,197,66
9/10/2021,South Dakota,858469,28,8873,193,64
9/11/2021,South Dakota,858469,20,8893,184,64
9/12/2021,South Dakota,858469,26,8919,188,62
9/13/2021,South Dakota,858469,27,8946,206,65
9/14/2021,South Dakota,858469,26,8972,196,63
9/15/2021,South Dakota,858469,34,9006,200,55
9/16/2021,South Dakota,858469,30,9036,197,67
9/17/2021,South Dakota,858469,30,9066,189,61
9/18/2021,South Dakota,858469,31,9097,200,63
9/19/2021,South Dakota,858469,19,9116,202,66
9/20/2021,South Dakota,858469,29,9145,222,70
9/21/2021,South Dakota,858469,23,9168,216,64
9/22/2021,South Dakota,858469,33,9201,197,61
9/23/2021,South Dakota,858469,23,9224,182,62
9/24/2021,South Dakota,858469,29,9253,181,62
9/25/2021,South Dakota,858469,21,9274,183,59
9/26/2021,South Dakota,858469,23,9297,183,61
9/27/2021,South Dakota,858469,25,9322,184,64
9/28/2021,South Dakota,858469,36,9358,192,59
9/29/2021,South Dakota,858469,29,9387,190,58
9/30/2021,South Dakota,858469,33,9420,193,62
10/1/2021,South Dakota,858469,30,9450,186,61
10/2/2021,South Dakota,858469,26,9476,192,60
10/3/2021,South Dakota,858469,26,9502,188,59
10/4/2021,South Dakota,858469,36,9538,204,63
10/5/2021,South Dakota,858469,30,9568,196,66
10/6/2021,South Dakota,858469,17,9585,198,67
10/7/2021,South Dakota,858469,32,9617,199,72
10/8/2021,South Dakota,858469,23,9640,199,55
10/9/2021,South Dakota,858469,28,9668,187,60
10/10/2021,South Dakota,858469,23,9691,187,64
10/11/2021,South Dakota,858469,26,9717,193,58
10/12/2021,South Dakota,858469,28,9745,190,60
10/13/2021,South Dakota,858469,20,9765,183,53
10/14/2021,South Dakota,858469,16,9781,175,41
10/15/2021,South Dakota,858469,23,9804,177,53
10/16/2021,South Dakota,858469,24,9828,176,54
10/17/2021,South Dakota,858469,26,9854,180,54
10/18/2021,South Dakota,858469,26,9880,178,56
10/19/2021,South Dakota,858469,41,9921,188,57
10/20/2021,South Dakota,858469,20,9941,184,56
10/21/2021,South Dakota,858469,31,9972,192,60
10/22/2021,South Dakota,858469,20,9992,167,54
10/23/2021,South Dakota,858469,28,10020,176,53
10/24/2021,South Dakota,858469,24,10044,171,50
10/25/2021,South Dakota,858469,20,10064,175,46
10/26/2021,South Dakota,858469,33,10097,182,45
10/27/2021,South Dakota,858469,27,10124,185,55
10/28/2021,South Dakota,858469,28,10152,174,47
10/29/2021,South Dakota,858469,42,10194,197,43
10/30/2021,South Dakota,858469,35,10229,186,45
10/31/2021,South Dakota,858469,31,10260,181,46
11/1/2021,South Dakota,858469,10,10270,177,54
11/2/2021,South Dakota,858469,22,10292,166,47
11/3/2021,South Dakota,858469,26,10318,160,49
11/4/2021,South Dakota,858469,31,10349,168,47
11/5/2021,South Dakota,858469,36,10385,173,49
11/6/2021,South Dakota,858469,36,10421,180,51
11/7/2021,South Dakota,858469,34,10455,192,54
11/8/2021,South Dakota,858469,40,10495,208,66
11/9/2021,South Dakota,858469,41,10536,219,64
11/10/2021,South Dakota,858469,43,10579,219,66
11/11/2021,South Dakota,858469,32,10611,219,68
11/12/2021,South Dakota,858469,39,10650,228,65
11/13/2021,South Dakota,858469,31,10681,230,62
11/14/2021,South Dakota,858469,36,10717,229,64
11/15/2021,South Dakota,858469,30,10747,230,66
11/16/2021,South Dakota,858469,44,10791,241,69
11/17/2021,South Dakota,858469,35,10826,243,71
11/18/2021,South Dakota,858469,35,10861,225,65
11/19/2021,South Dakota,858469,29,10890,224,65
11/20/2021,South Dakota,858469,35,10925,218,66
11/21/2021,South Dakota,858469,23,10948,218,70
11/22/2021,South Dakota,858469,34,10982,228,69
11/23/2021,South Dakota,858469,34,11016,218,66
11/24/2021,South Dakota,858469,38,11054,216,65
11/25/2021,South Dakota,858469,35,11089,212,68
11/26/2021,South Dakota,858469,33,11122,228,68
11/27/2021,South Dakota,858469,40,11162,234,70
11/28/2021,South Dakota,858469,20,11182,224,65
11/29/2021,South Dakota,858469,35,11217,230,64
11/30/2021,South Dakota,858469,45,11262,239,73
12/1/2021,South Dakota,858469,35,11297,227,64
12/2/2021,South Dakota,858469,31,11328,233,59
12/3/2021,South Dakota,858469,46,11374,236,66
12/4/2021,South Dakota,858469,41,11415,231,67
12/5/2021,South Dakota,858469,34,11449,232,69
12/6/2021,South Dakota,858469,36,11485,233,76
12/7/2021,South Dakota,858469,59,11544,247,84
12/8/2021,South Dakota,858469,48,11592,249,79
12/9/2021,South Dakota,858469,33,11625,245,83
12/10/2021,South Dakota,858469,41,11666,246,84
12/11/2021,South Dakota,858469,46,11712,242,78
12/12/2021,South Dakota,858469,35,11747,244,87
12/13/2021,South Dakota,858469,36,11783,251,85
12/14/2021,South Dakota,858469,34,11817,245,81
12/15/2021,South Dakota,858469,33,11850,241,80
12/16/2021,South Dakota,858469,32,11882,225,77
12/17/2021,South Dakota,858469,37,11919,225,77
12/18/2021,South Dakota,858469,35,11954,226,78
12/19/2021,South Dakota,858469,16,11970,220,75
12/20/2021,South Dakota,858469,33,12003,221,71
12/21/2021,South Dakota,858469,29,12032,215,74
12/22/2021,South Dakota,858469,28,12060,215,73
12/23/2021,South Dakota,858469,45,12105,216,68
12/24/2021,South Dakota,858469,36,12141,209,70
12/25/2021,South Dakota,858469,23,12164,208,74
12/26/2021,South Dakota,858469,20,12184,204,71
12/27/2021,South Dakota,858469,22,12206,197,70
12/28/2021,South Dakota,858469,34,12240,200,72
12/29/2021,South Dakota,858469,38,12278,203,75
12/30/2021,South Dakota,858469,31,12309,209,74
12/31/2021,South Dakota,858469,31,12340,200,73
1/1/2022,South Dakota,858469,31,12371,193,67
1/2/2022,South Dakota,858469,27,12398,219,73
1/3/2022,South Dakota,858469,34,12432,228,71
1/4/2022,South Dakota,858469,45,12477,250,74
1/5/2022,South Dakota,858469,41,12518,271,76
1/6/2022,South Dakota,858469,48,12566,271,63
1/7/2022,South Dakota,858469,44,12610,274,63
1/8/2022,South Dakota,858469,37,12647,269,63
1/9/2022,South Dakota,858469,39,12686,259,66
1/10/2022,South Dakota,858469,37,12723,271,76
1/11/2022,South Dakota,858469,64,12787,294,74
1/12/2022,South Dakota,858469,60,12847,304,69
1/13/2022,South Dakota,858469,79,12926,316,69
1/14/2022,South Dakota,858469,65,12991,313,75
1/15/2022,South Dakota,858469,79,13070,325,71
1/16/2022,South Dakota,858469,65,13135,331,69
1/17/2022,South Dakota,858469,73,13208,342,74
1/18/2022,South Dakota,858469,66,13274,348,75
1/19/2022,South Dakota,858469,78,13352,366,75
1/20/2022,South Dakota,858469,68,13420,368,79
1/21/2022,South Dakota,858469,71,13491,364,81
1/22/2022,South Dakota,858469,84,13575,376,86
1/23/2022,South Dakota,858469,59,13634,385,90
1/24/2022,South Dakota,858469,55,13689,381,86
1/25/2022,South Dakota,858469,58,13747,356,73
1/26/2022,South Dakota,858469,62,13809,369,75
1/27/2022,South Dakota,858469,62,13871,381,73
1/28/2022,South Dakota,858469,57,13928,351,68
1/29/2022,South Dakota,858469,75,14003,361,69
1/30/2022,South Dakota,858469,37,14040,346,68
1/31/2022,South Dakota,858469,30,14070,337,61
2/1/2022,South Dakota,858469,62,14132,332,73
2/2/2022,South Dakota,858469,47,14179,323,67
2/3/2022,South Dakota,858469,66,14245,327,62
2/4/2022,South Dakota,858469,41,14286,312,59
2/5/2022,South Dakota,858469,39,14325,282,56
2/6/2022,South Dakota,858469,31,14356,276,58
2/7/2022,South Dakota,858469,23,14379,288,60
2/8/2022,South Dakota,858469,45,14424,285,62
2/9/2022,South Dakota,858469,45,14469,285,62
7/1/2021,Tennessee,6600299,38,53589,225,69
7/2/2021,Tennessee,6600299,18,53607,215,69
7/3/2021,Tennessee,6600299,20,53627,203,74
7/4/2021,Tennessee,6600299,20,53647,199,74
7/5/2021,Tennessee,6600299,32,53679,225,83
7/6/2021,Tennessee,6600299,33,53712,240,77
7/7/2021,Tennessee,6600299,30,53742,244,86
7/8/2021,Tennessee,6600299,24,53766,241,82
7/9/2021,Tennessee,6600299,31,53797,239,82
7/10/2021,Tennessee,6600299,35,53832,246,86
7/11/2021,Tennessee,6600299,39,53871,273,89
7/12/2021,Tennessee,6600299,41,53912,290,93
7/13/2021,Tennessee,6600299,53,53965,317,103
7/14/2021,Tennessee,6600299,48,54013,334,113
7/15/2021,Tennessee,6600299,43,54056,349,121
7/16/2021,Tennessee,6600299,56,54112,375,132
7/17/2021,Tennessee,6600299,74,54186,408,133
7/18/2021,Tennessee,6600299,63,54249,434,150
7/19/2021,Tennessee,6600299,72,54321,490,166
7/20/2021,Tennessee,6600299,87,54408,526,192
7/21/2021,Tennessee,6600299,89,54497,568,199
7/22/2021,Tennessee,6600299,88,54585,601,215
7/23/2021,Tennessee,6600299,97,54682,656,219
7/24/2021,Tennessee,6600299,97,54779,678,210
7/25/2021,Tennessee,6600299,76,54855,722,230
7/26/2021,Tennessee,6600299,116,54971,772,250
7/27/2021,Tennessee,6600299,137,55108,829,265
7/28/2021,Tennessee,6600299,161,55269,910,294
7/29/2021,Tennessee,6600299,153,55422,1004,302
7/30/2021,Tennessee,6600299,156,55578,1041,316
7/31/2021,Tennessee,6600299,181,55759,1103,348
8/1/2021,Tennessee,6600299,144,55903,1194,377
8/2/2021,Tennessee,6600299,197,56100,1269,402
8/3/2021,Tennessee,6600299,207,56307,1346,413
8/4/2021,Tennessee,6600299,231,56538,1447,441
8/5/2021,Tennessee,6600299,216,56754,1520,452
8/6/2021,Tennessee,6600299,250,57004,1642,471
8/7/2021,Tennessee,6600299,224,57228,1654,482
8/8/2021,Tennessee,6600299,233,57461,1750,505
8/9/2021,Tennessee,6600299,272,57733,1821,536
8/10/2021,Tennessee,6600299,288,58021,1950,550
8/11/2021,Tennessee,6600299,278,58299,2050,594
8/12/2021,Tennessee,6600299,309,58608,2110,598
8/13/2021,Tennessee,6600299,311,58919,2185,647
8/14/2021,Tennessee,6600299,291,59210,2222,678
8/15/2021,Tennessee,6600299,238,59448,2290,699
8/16/2021,Tennessee,6600299,288,59736,2379,701
8/17/2021,Tennessee,6600299,332,60068,2513,738
8/18/2021,Tennessee,6600299,312,60380,2550,753
8/19/2021,Tennessee,6600299,331,60711,2619,772
8/20/2021,Tennessee,6600299,346,61057,2684,789
8/21/2021,Tennessee,6600299,300,61357,2667,779
8/22/2021,Tennessee,6600299,291,61648,2769,831
8/23/2021,Tennessee,6600299,350,61998,2900,822
8/24/2021,Tennessee,6600299,362,62360,2980,863
8/25/2021,Tennessee,6600299,372,62732,2986,868
8/26/2021,Tennessee,6600299,385,63117,3133,892
8/27/2021,Tennessee,6600299,373,63490,3162,900
8/28/2021,Tennessee,6600299,401,63891,3197,927
8/29/2021,Tennessee,6600299,315,64206,3272,913
8/30/2021,Tennessee,6600299,372,64578,3357,944
8/31/2021,Tennessee,6600299,458,65036,3436,945
9/1/2021,Tennessee,6600299,463,65499,3565,964
9/2/2021,Tennessee,6600299,461,65960,3634,979
9/3/2021,Tennessee,6600299,396,66356,3658,1000
9/4/2021,Tennessee,6600299,381,66737,3620,1009
9/5/2021,Tennessee,6600299,371,67108,3675,1035
9/6/2021,Tennessee,6600299,362,67470,3764,1045
9/7/2021,Tennessee,6600299,393,67863,3843,1085
9/8/2021,Tennessee,6600299,431,68294,3881,1085
9/9/2021,Tennessee,6600299,441,68735,3913,1085
9/10/2021,Tennessee,6600299,426,69161,3857,1085
9/11/2021,Tennessee,6600299,365,69526,3800,1072
9/12/2021,Tennessee,6600299,292,69818,3744,1090
9/13/2021,Tennessee,6600299,286,70104,3731,1080
9/14/2021,Tennessee,6600299,358,70462,3591,1053
9/15/2021,Tennessee,6600299,364,70826,3675,1064
9/16/2021,Tennessee,6600299,345,71171,3615,1050
9/17/2021,Tennessee,6600299,336,71507,3559,1048
9/18/2021,Tennessee,6600299,295,71802,3416,1028
9/19/2021,Tennessee,6600299,258,72060,3334,993
9/20/2021,Tennessee,6600299,261,72321,3315,972
9/21/2021,Tennessee,6600299,283,72604,3237,987
9/22/2021,Tennessee,6600299,306,72910,3159,940
9/23/2021,Tennessee,6600299,257,73167,3014,928
9/24/2021,Tennessee,6600299,240,73407,2907,896
9/25/2021,Tennessee,6600299,244,73651,2812,865
9/26/2021,Tennessee,6600299,223,73874,2782,831
9/27/2021,Tennessee,6600299,213,74087,2753,834
9/28/2021,Tennessee,6600299,245,74332,2675,812
9/29/2021,Tennessee,6600299,248,74580,2624,785
9/30/2021,Tennessee,6600299,206,74786,2479,736
10/1/2021,Tennessee,6600299,197,74983,2414,732
10/2/2021,Tennessee,6600299,166,75149,2254,711
10/3/2021,Tennessee,6600299,157,75306,2186,696
10/4/2021,Tennessee,6600299,165,75471,2186,702
10/5/2021,Tennessee,6600299,200,75671,2143,686
10/6/2021,Tennessee,6600299,170,75841,2033,661
10/7/2021,Tennessee,6600299,201,76042,2084,626
10/8/2021,Tennessee,6600299,154,76196,1938,586
10/9/2021,Tennessee,6600299,140,76336,1894,612
10/10/2021,Tennessee,6600299,119,76455,1807,589
10/11/2021,Tennessee,6600299,156,76611,1784,554
10/12/2021,Tennessee,6600299,151,76762,1721,556
10/13/2021,Tennessee,6600299,169,76931,1677,547
10/14/2021,Tennessee,6600299,150,77081,1620,506
10/15/2021,Tennessee,6600299,153,77234,1563,475
10/16/2021,Tennessee,6600299,121,77355,1478,472
10/17/2021,Tennessee,6600299,107,77462,1465,454
10/18/2021,Tennessee,6600299,96,77558,1441,453
10/19/2021,Tennessee,6600299,118,77676,1401,442
10/20/2021,Tennessee,6600299,123,77799,1356,425
10/21/2021,Tennessee,6600299,123,77922,1304,419
10/22/2021,Tennessee,6600299,111,78033,1274,376
10/23/2021,Tennessee,6600299,99,78132,1197,361
10/24/2021,Tennessee,6600299,76,78208,1170,368
10/25/2021,Tennessee,6600299,80,78288,1169,352
10/26/2021,Tennessee,6600299,95,78383,1144,355
10/27/2021,Tennessee,6600299,88,78471,1103,345
10/28/2021,Tennessee,6600299,83,78554,1047,325
10/29/2021,Tennessee,6600299,95,78649,1009,321
10/30/2021,Tennessee,6600299,74,78723,976,305
10/31/2021,Tennessee,6600299,70,78793,949,295
11/1/2021,Tennessee,6600299,44,78837,924,298
11/2/2021,Tennessee,6600299,100,78937,896,292
11/3/2021,Tennessee,6600299,73,79010,874,275
11/4/2021,Tennessee,6600299,80,79090,839,258
11/5/2021,Tennessee,6600299,79,79169,819,240
11/6/2021,Tennessee,6600299,74,79243,790,260
11/7/2021,Tennessee,6600299,55,79298,788,259
11/8/2021,Tennessee,6600299,67,79365,775,258
11/9/2021,Tennessee,6600299,89,79454,775,256
11/10/2021,Tennessee,6600299,76,79530,761,236
11/11/2021,Tennessee,6600299,75,79605,761,224
11/12/2021,Tennessee,6600299,88,79693,740,213
11/13/2021,Tennessee,6600299,61,79754,711,208
11/14/2021,Tennessee,6600299,57,79811,689,208
11/15/2021,Tennessee,6600299,61,79872,700,220
11/16/2021,Tennessee,6600299,85,79957,710,227
11/17/2021,Tennessee,6600299,93,80050,735,237
11/18/2021,Tennessee,6600299,93,80143,739,216
11/19/2021,Tennessee,6600299,85,80228,747,218
11/20/2021,Tennessee,6600299,101,80329,744,227
11/21/2021,Tennessee,6600299,77,80406,743,219
11/22/2021,Tennessee,6600299,77,80483,749,217
11/23/2021,Tennessee,6600299,99,80582,783,230
11/24/2021,Tennessee,6600299,92,80674,761,228
11/25/2021,Tennessee,6600299,90,80764,722,229
11/26/2021,Tennessee,6600299,96,80860,753,235
11/27/2021,Tennessee,6600299,127,80987,802,255
11/28/2021,Tennessee,6600299,100,81087,840,254
11/29/2021,Tennessee,6600299,100,81187,857,244
11/30/2021,Tennessee,6600299,114,81301,881,260
12/1/2021,Tennessee,6600299,123,81424,882,266
12/2/2021,Tennessee,6600299,116,81540,890,260
12/3/2021,Tennessee,6600299,118,81658,889,264
12/4/2021,Tennessee,6600299,110,81768,878,253
12/5/2021,Tennessee,6600299,104,81872,924,259
12/6/2021,Tennessee,6600299,107,81979,958,257
12/7/2021,Tennessee,6600299,123,82102,1005,269
12/8/2021,Tennessee,6600299,118,82220,1007,279
12/9/2021,Tennessee,6600299,135,82355,1032,278
12/10/2021,Tennessee,6600299,147,82502,1084,285
12/11/2021,Tennessee,6600299,118,82620,1047,292
12/12/2021,Tennessee,6600299,131,82751,1059,306
12/13/2021,Tennessee,6600299,109,82860,1092,313
12/14/2021,Tennessee,6600299,118,82978,1105,319
12/15/2021,Tennessee,6600299,118,83096,1102,310
12/16/2021,Tennessee,6600299,127,83223,1123,326
12/17/2021,Tennessee,6600299,128,83351,1120,326
12/18/2021,Tennessee,6600299,119,83470,1104,332
12/19/2021,Tennessee,6600299,119,83589,1125,327
12/20/2021,Tennessee,6600299,126,83715,1144,346
12/21/2021,Tennessee,6600299,120,83835,1125,339
12/22/2021,Tennessee,6600299,144,83979,1150,356
12/23/2021,Tennessee,6600299,154,84133,1194,357
12/24/2021,Tennessee,6600299,156,84289,1180,349
12/25/2021,Tennessee,6600299,143,84432,1156,348
12/26/2021,Tennessee,6600299,174,84606,1224,366
12/27/2021,Tennessee,6600299,193,84799,1332,385
12/28/2021,Tennessee,6600299,240,85039,1434,397
12/29/2021,Tennessee,6600299,256,85295,1553,407
12/30/2021,Tennessee,6600299,289,85584,1683,416
12/31/2021,Tennessee,6600299,286,85870,1731,433
1/1/2022,Tennessee,6600299,275,86145,1771,438
1/2/2022,Tennessee,6600299,286,86431,1902,474
1/3/2022,Tennessee,6600299,310,86741,2023,493
1/4/2022,Tennessee,6600299,351,87092,2186,519
1/5/2022,Tennessee,6600299,393,87485,2369,538
1/6/2022,Tennessee,6600299,371,87856,2484,553
1/7/2022,Tennessee,6600299,324,88180,2543,561
1/8/2022,Tennessee,6600299,330,88510,2568,582
1/9/2022,Tennessee,6600299,357,88867,2704,600
1/10/2022,Tennessee,6600299,379,89246,2838,621
1/11/2022,Tennessee,6600299,401,89647,2898,656
1/12/2022,Tennessee,6600299,433,90080,3062,649
1/13/2022,Tennessee,6600299,414,90494,3119,645
1/14/2022,Tennessee,6600299,407,90901,3197,664
1/15/2022,Tennessee,6600299,374,91275,3105,663
1/16/2022,Tennessee,6600299,329,91604,3087,662
1/17/2022,Tennessee,6600299,323,91927,3201,651
1/18/2022,Tennessee,6600299,422,92349,3271,675
1/19/2022,Tennessee,6600299,478,92827,3424,671
1/20/2022,Tennessee,6600299,418,93245,3410,675
1/21/2022,Tennessee,6600299,421,93666,3415,668
1/22/2022,Tennessee,6600299,421,94087,3371,654
1/23/2022,Tennessee,6600299,369,94456,3469,668
1/24/2022,Tennessee,6600299,374,94830,3442,666
1/25/2022,Tennessee,6600299,440,95270,3482,671
1/26/2022,Tennessee,6600299,445,95715,3597,681
1/27/2022,Tennessee,6600299,424,96139,3538,687
1/28/2022,Tennessee,6600299,462,96601,3525,665
1/29/2022,Tennessee,6600299,464,97065,3483,658
1/30/2022,Tennessee,6600299,366,97431,3507,666
1/31/2022,Tennessee,6600299,329,97760,3533,664
2/1/2022,Tennessee,6600299,399,98159,3491,672
2/2/2022,Tennessee,6600299,394,98553,3442,673
2/3/2022,Tennessee,6600299,384,98937,3369,676
2/4/2022,Tennessee,6600299,366,99303,3243,648
2/5/2022,Tennessee,6600299,283,99586,3080,616
2/6/2022,Tennessee,6600299,275,99861,3057,616
2/7/2022,Tennessee,6600299,275,100136,3035,596
2/8/2022,Tennessee,6600299,301,100437,2953,582
2/9/2022,Tennessee,6600299,301,100738,2953,582
7/1/2021,Texas,27469114,242,260371,1593,491
7/2/2021,Texas,27469114,254,260625,1601,498
7/3/2021,Texas,27469114,256,260881,1667,521
7/4/2021,Texas,27469114,224,261105,1694,533
7/5/2021,Texas,27469114,247,261352,1736,547
7/6/2021,Texas,27469114,250,261602,1721,563
7/7/2021,Texas,27469114,330,261932,1856,592
7/8/2021,Texas,27469114,327,262259,1925,629
7/9/2021,Texas,27469114,325,262584,1947,658
7/10/2021,Texas,27469114,338,262922,1974,677
7/11/2021,Texas,27469114,368,263290,2109,706
7/12/2021,Texas,27469114,388,263678,2283,741
7/13/2021,Texas,27469114,402,264080,2428,743
7/14/2021,Texas,27469114,394,264474,2539,792
7/15/2021,Texas,27469114,419,264893,2674,811
7/16/2021,Texas,27469114,504,265397,2865,928
7/17/2021,Texas,27469114,518,265915,2975,960
7/18/2021,Texas,27469114,468,266383,3077,988
7/19/2021,Texas,27469114,568,266951,3349,1035
7/20/2021,Texas,27469114,617,267568,3605,1108
7/21/2021,Texas,27469114,624,268192,3732,1153
7/22/2021,Texas,27469114,670,268862,3929,1174
7/23/2021,Texas,27469114,736,269598,4202,1250
7/24/2021,Texas,27469114,801,270399,4379,1322
7/25/2021,Texas,27469114,754,271153,4686,1369
7/26/2021,Texas,27469114,777,271930,5037,1464
7/27/2021,Texas,27469114,984,272914,5396,1542
7/28/2021,Texas,27469114,998,273912,5744,1600
7/29/2021,Texas,27469114,960,274872,5918,1667
7/30/2021,Texas,27469114,1138,276010,6362,1741
7/31/2021,Texas,27469114,1130,277140,6702,1817
8/1/2021,Texas,27469114,1051,278191,6978,1901
8/2/2021,Texas,27469114,1164,279355,7379,2007
8/3/2021,Texas,27469114,1368,280723,7776,2113
8/4/2021,Texas,27469114,1397,282120,8208,2203
8/5/2021,Texas,27469114,1407,283527,8693,2276
8/6/2021,Texas,27469114,1482,285009,9010,2386
8/7/2021,Texas,27469114,1534,286543,9259,2455
8/8/2021,Texas,27469114,1521,288064,9736,2526
8/9/2021,Texas,27469114,1520,289584,10182,2687
8/10/2021,Texas,27469114,1657,291241,10613,2737
8/11/2021,Texas,27469114,1672,292913,10985,2886
8/12/2021,Texas,27469114,1801,294714,11519,2965
8/13/2021,Texas,27469114,1752,296466,11527,2962
8/14/2021,Texas,27469114,1747,298213,11658,3071
8/15/2021,Texas,27469114,1532,299745,11884,3153
8/16/2021,Texas,27469114,1566,301311,12371,3237
8/17/2021,Texas,27469114,1831,303142,12560,3297
8/18/2021,Texas,27469114,1797,304939,12855,3367
8/19/2021,Texas,27469114,1791,306730,13075,3419
8/20/2021,Texas,27469114,1774,308504,13127,3507
8/21/2021,Texas,27469114,1838,310342,13295,3610
8/22/2021,Texas,27469114,1719,312061,13532,3662
8/23/2021,Texas,27469114,1698,313759,13818,3671
8/24/2021,Texas,27469114,1762,315521,14058,3791
8/25/2021,Texas,27469114,1724,317245,14022,3759
8/26/2021,Texas,27469114,1680,318925,13961,3820
8/27/2021,Texas,27469114,1807,320732,13971,3831
8/28/2021,Texas,27469114,1631,322363,13756,3822
8/29/2021,Texas,27469114,1580,323943,13969,3877
8/30/2021,Texas,27469114,1540,325483,14058,3849
8/31/2021,Texas,27469114,1756,327239,14135,3850
9/1/2021,Texas,27469114,1813,329052,13988,3869
9/2/2021,Texas,27469114,1650,330702,14109,3900
9/3/2021,Texas,27469114,1703,332405,13932,3880
9/4/2021,Texas,27469114,1734,334139,13860,3878
9/5/2021,Texas,27469114,1514,335653,13697,3854
9/6/2021,Texas,27469114,1457,337110,13656,3802
9/7/2021,Texas,27469114,1500,338610,13742,3845
9/8/2021,Texas,27469114,1623,340233,13641,3801
9/9/2021,Texas,27469114,1664,341897,13680,3895
9/10/2021,Texas,27469114,1510,343407,13510,3864
9/11/2021,Texas,27469114,1581,344988,13289,3818
9/12/2021,Texas,27469114,1320,346308,13107,3752
9/13/2021,Texas,27469114,1355,347663,13172,3786
9/14/2021,Texas,27469114,1486,349149,13022,3657
9/15/2021,Texas,27469114,1323,350472,12743,3716
9/16/2021,Texas,27469114,1421,351893,12744,3752
9/17/2021,Texas,27469114,1301,353194,12466,3648
9/18/2021,Texas,27469114,1291,354485,12016,3602
9/19/2021,Texas,27469114,1247,355732,11891,3574
9/20/2021,Texas,27469114,1022,356754,11853,3496
9/21/2021,Texas,27469114,1178,357932,11545,3493
9/22/2021,Texas,27469114,1207,359139,11241,3417
9/23/2021,Texas,27469114,1170,360309,10972,3291
9/24/2021,Texas,27469114,1117,361426,10542,3259
9/25/2021,Texas,27469114,1067,362493,10084,3187
9/26/2021,Texas,27469114,905,363398,9918,3166
9/27/2021,Texas,27469114,869,364267,9698,3097
9/28/2021,Texas,27469114,997,365264,9486,3066
9/29/2021,Texas,27469114,942,366206,9094,2952
9/30/2021,Texas,27469114,892,367098,8849,2844
10/1/2021,Texas,27469114,815,367913,8399,2729
10/2/2021,Texas,27469114,837,368750,8116,2637
10/3/2021,Texas,27469114,700,369450,8014,2635
10/4/2021,Texas,27469114,671,370121,7899,2606
10/5/2021,Texas,27469114,742,370863,7567,2496
10/6/2021,Texas,27469114,777,371640,7222,2376
10/7/2021,Texas,27469114,712,372352,7141,2300
10/8/2021,Texas,27469114,649,373001,6859,2266
10/9/2021,Texas,27469114,630,373631,6577,2238
10/10/2021,Texas,27469114,568,374199,6311,2177
10/11/2021,Texas,27469114,571,374770,6179,2077
10/12/2021,Texas,27469114,633,375403,6094,2022
10/13/2021,Texas,27469114,590,375993,5853,2026
10/14/2021,Texas,27469114,599,376592,5758,1972
10/15/2021,Texas,27469114,535,377127,5512,1869
10/16/2021,Texas,27469114,511,377638,5234,1807
10/17/2021,Texas,27469114,438,378076,5134,1777
10/18/2021,Texas,27469114,423,378499,5106,1772
10/19/2021,Texas,27469114,531,379030,4822,1706
10/20/2021,Texas,27469114,504,379534,4717,1708
10/21/2021,Texas,27469114,530,380064,4701,1649
10/22/2021,Texas,27469114,484,380548,4525,1616
10/23/2021,Texas,27469114,444,380992,4307,1526
10/24/2021,Texas,27469114,397,381389,4190,1493
10/25/2021,Texas,27469114,391,381780,4177,1508
10/26/2021,Texas,27469114,380,382160,4084,1455
10/27/2021,Texas,27469114,418,382578,3860,1448
10/28/2021,Texas,27469114,396,382974,3757,1366
10/29/2021,Texas,27469114,361,383335,3645,1312
10/30/2021,Texas,27469114,374,383709,3509,1259
10/31/2021,Texas,27469114,324,384033,3465,1240
11/1/2021,Texas,27469114,295,384328,3399,1213
11/2/2021,Texas,27469114,361,384689,3242,1139
11/3/2021,Texas,27469114,336,385025,3131,1125
11/4/2021,Texas,27469114,310,385335,3090,1137
11/5/2021,Texas,27469114,300,385635,3020,1117
11/6/2021,Texas,27469114,290,385925,2853,1056
11/7/2021,Texas,27469114,259,386184,2874,1062
11/8/2021,Texas,27469114,289,386473,2805,1012
11/9/2021,Texas,27469114,371,386844,2838,981
11/10/2021,Texas,27469114,350,387194,2766,978
11/11/2021,Texas,27469114,347,387541,2798,968
11/12/2021,Texas,27469114,353,387894,2797,969
11/13/2021,Texas,27469114,343,388237,2737,953
11/14/2021,Texas,27469114,311,388548,2717,951
11/15/2021,Texas,27469114,298,388846,2811,963
11/16/2021,Texas,27469114,386,389232,2783,946
11/17/2021,Texas,27469114,363,389595,2736,941
11/18/2021,Texas,27469114,370,389965,2813,963
11/19/2021,Texas,27469114,310,390275,2733,929
11/20/2021,Texas,27469114,332,390607,2685,922
11/21/2021,Texas,27469114,324,390931,2691,915
11/22/2021,Texas,27469114,330,391261,2757,933
11/23/2021,Texas,27469114,386,391647,2745,909
11/24/2021,Texas,27469114,380,392027,2305,772
11/25/2021,Texas,27469114,414,392441,3050,1013
11/26/2021,Texas,27469114,363,392804,3070,1027
11/27/2021,Texas,27469114,421,393225,3108,1030
11/28/2021,Texas,27469114,424,393649,3157,1049
11/29/2021,Texas,27469114,378,394027,2907,958
11/30/2021,Texas,27469114,430,394457,2962,978
12/1/2021,Texas,27469114,399,394856,2944,968
12/2/2021,Texas,27469114,389,395245,2960,967
12/3/2021,Texas,27469114,405,395650,2949,930
12/4/2021,Texas,27469114,440,396090,3004,950
12/5/2021,Texas,27469114,436,396526,3051,955
12/6/2021,Texas,27469114,423,396949,3125,957
12/7/2021,Texas,27469114,411,397360,3137,954
12/8/2021,Texas,27469114,462,397822,3162,963
12/9/2021,Texas,27469114,406,398228,3187,977
12/10/2021,Texas,27469114,444,398672,3221,965
12/11/2021,Texas,27469114,448,399120,3183,956
12/12/2021,Texas,27469114,372,399492,3174,964
12/13/2021,Texas,27469114,348,399840,3266,1002
12/14/2021,Texas,27469114,401,400241,3244,984
12/15/2021,Texas,27469114,446,400687,3181,984
12/16/2021,Texas,27469114,419,401106,3143,961
12/17/2021,Texas,27469114,476,401582,3200,984
12/18/2021,Texas,27469114,459,402041,3131,970
12/19/2021,Texas,27469114,396,402437,3160,976
12/20/2021,Texas,27469114,427,402864,3234,1013
12/21/2021,Texas,27469114,519,403383,3329,1013
12/22/2021,Texas,27469114,564,403947,3423,1018
12/23/2021,Texas,27469114,615,404562,3558,1040
12/24/2021,Texas,27469114,656,405218,3644,1039
12/25/2021,Texas,27469114,681,405899,3769,1086
12/26/2021,Texas,27469114,698,406597,4017,1089
12/27/2021,Texas,27469114,821,407418,4507,1161
12/28/2021,Texas,27469114,1197,408615,5031,1188
12/29/2021,Texas,27469114,1308,409923,5636,1272
12/30/2021,Texas,27469114,1360,411283,6134,1311
12/31/2021,Texas,27469114,1465,412748,6513,1354
1/1/2022,Texas,27469114,1414,414162,6762,1425
1/2/2022,Texas,27469114,1308,415470,7140,1483
1/3/2022,Texas,27469114,1352,416822,7634,1569
1/4/2022,Texas,27469114,1670,418492,8320,1642
1/5/2022,Texas,27469114,1821,420313,9005,1759
1/6/2022,Texas,27469114,1893,422206,9531,1834
1/7/2022,Texas,27469114,1885,424091,10070,1932
1/8/2022,Texas,27469114,1883,425974,10230,1973
1/9/2022,Texas,27469114,1839,427813,10578,2063
1/10/2022,Texas,27469114,1859,429672,11287,2176
1/11/2022,Texas,27469114,2022,431694,11797,2250
1/12/2022,Texas,27469114,2085,433779,11902,2325
1/13/2022,Texas,27469114,2122,435901,12274,2375
1/14/2022,Texas,27469114,2215,438116,12477,2372
1/15/2022,Texas,27469114,2163,440279,12621,2470
1/16/2022,Texas,27469114,1912,442191,12714,2545
1/17/2022,Texas,27469114,1815,444006,12760,2519
1/18/2022,Texas,27469114,2205,446211,13255,2604
1/19/2022,Texas,27469114,2324,448535,13427,2678
1/20/2022,Texas,27469114,2243,450778,13771,2688
1/21/2022,Texas,27469114,2120,452898,13792,2737
1/22/2022,Texas,27469114,2069,454967,13487,2719
1/23/2022,Texas,27469114,1794,456761,13433,2769
1/24/2022,Texas,27469114,1782,458543,13632,2772
1/25/2022,Texas,27469114,2089,460632,13608,2765
1/26/2022,Texas,27469114,2102,462734,13605,2844
1/27/2022,Texas,27469114,1929,464663,13432,2793
1/28/2022,Texas,27469114,1914,466577,13061,2795
1/29/2022,Texas,27469114,1794,468371,12715,2798
1/30/2022,Texas,27469114,1584,469955,12507,2765
1/31/2022,Texas,27469114,1535,471490,12444,2729
2/1/2022,Texas,27469114,1729,473219,12280,2754
2/2/2022,Texas,27469114,1664,474883,11837,2620
2/3/2022,Texas,27469114,1515,476398,11467,2562
2/4/2022,Texas,27469114,1218,477616,10960,2489
2/5/2022,Texas,27469114,1227,478843,10348,2400
2/6/2022,Texas,27469114,1193,480036,9908,2347
2/7/2022,Texas,27469114,1078,481114,9710,2301
2/8/2022,Texas,27469114,1246,482360,9461,2272
2/9/2022,Texas,27469114,1246,483606,9461,2272
7/1/2021,Utah,2763885,32,15225,201,83
7/2/2021,Utah,2763885,47,15272,221,88
7/3/2021,Utah,2763885,37,15309,215,88
7/4/2021,Utah,2763885,33,15342,207,89
7/5/2021,Utah,2763885,38,15380,221,93
7/6/2021,Utah,2763885,33,15413,211,90
7/7/2021,Utah,2763885,46,15459,222,93
7/8/2021,Utah,2763885,31,15490,227,99
7/9/2021,Utah,2763885,44,15534,226,100
7/10/2021,Utah,2763885,25,15559,209,97
7/11/2021,Utah,2763885,26,15585,212,99
7/12/2021,Utah,2763885,46,15631,228,102
7/13/2021,Utah,2763885,47,15678,239,111
7/14/2021,Utah,2763885,43,15721,253,113
7/15/2021,Utah,2763885,50,15771,268,115
7/16/2021,Utah,2763885,48,15819,270,119
7/17/2021,Utah,2763885,49,15868,277,125
7/18/2021,Utah,2763885,33,15901,272,119
7/19/2021,Utah,2763885,46,15947,285,124
7/20/2021,Utah,2763885,40,15987,287,122
7/21/2021,Utah,2763885,42,16029,283,126
7/22/2021,Utah,2763885,58,16087,295,132
7/23/2021,Utah,2763885,50,16137,300,138
7/24/2021,Utah,2763885,39,16176,301,143
7/25/2021,Utah,2763885,53,16229,313,138
7/26/2021,Utah,2763885,48,16277,316,146
7/27/2021,Utah,2763885,51,16328,327,155
7/28/2021,Utah,2763885,53,16381,336,148
7/29/2021,Utah,2763885,49,16430,327,145
7/30/2021,Utah,2763885,61,16491,335,140
7/31/2021,Utah,2763885,61,16552,351,160
8/1/2021,Utah,2763885,48,16600,346,158
8/2/2021,Utah,2763885,64,16664,373,168
8/3/2021,Utah,2763885,65,16729,369,164
8/4/2021,Utah,2763885,51,16780,367,163
8/5/2021,Utah,2763885,56,16836,344,159
8/6/2021,Utah,2763885,79,16915,363,155
8/7/2021,Utah,2763885,69,16984,355,157
8/8/2021,Utah,2763885,44,17028,360,155
8/9/2021,Utah,2763885,51,17079,367,150
8/10/2021,Utah,2763885,70,17149,368,145
8/11/2021,Utah,2763885,62,17211,370,150
8/12/2021,Utah,2763885,65,17276,369,147
8/13/2021,Utah,2763885,59,17335,371,142
8/14/2021,Utah,2763885,66,17401,361,153
8/15/2021,Utah,2763885,57,17458,365,152
8/16/2021,Utah,2763885,55,17513,360,153
8/17/2021,Utah,2763885,63,17576,371,147
8/18/2021,Utah,2763885,66,17642,371,151
8/19/2021,Utah,2763885,71,17713,384,148
8/20/2021,Utah,2763885,58,17771,378,153
8/21/2021,Utah,2763885,70,17841,383,156
8/22/2021,Utah,2763885,71,17912,397,159
8/23/2021,Utah,2763885,68,17980,401,161
8/24/2021,Utah,2763885,82,18062,430,172
8/25/2021,Utah,2763885,70,18132,437,177
8/26/2021,Utah,2763885,78,18210,442,175
8/27/2021,Utah,2763885,69,18279,455,173
8/28/2021,Utah,2763885,68,18347,449,175
8/29/2021,Utah,2763885,63,18410,435,164
8/30/2021,Utah,2763885,79,18489,460,174
8/31/2021,Utah,2763885,82,18571,467,173
9/1/2021,Utah,2763885,68,18639,472,178
9/2/2021,Utah,2763885,47,18686,442,177
9/3/2021,Utah,2763885,77,18763,473,187
9/4/2021,Utah,2763885,84,18847,483,186
9/5/2021,Utah,2763885,72,18919,465,169
9/6/2021,Utah,2763885,64,18983,470,185
9/7/2021,Utah,2763885,65,19048,469,180
9/8/2021,Utah,2763885,93,19141,500,185
9/9/2021,Utah,2763885,90,19231,510,190
9/10/2021,Utah,2763885,102,19333,508,201
9/11/2021,Utah,2763885,99,19432,516,195
9/12/2021,Utah,2763885,66,19498,533,212
9/13/2021,Utah,2763885,66,19564,542,213
9/14/2021,Utah,2763885,74,19638,526,210
9/15/2021,Utah,2763885,85,19723,517,218
9/16/2021,Utah,2763885,84,19807,550,217
9/17/2021,Utah,2763885,94,19901,554,217
9/18/2021,Utah,2763885,81,19982,544,223
9/19/2021,Utah,2763885,80,20062,547,222
9/20/2021,Utah,2763885,70,20132,543,217
9/21/2021,Utah,2763885,75,20207,532,222
9/22/2021,Utah,2763885,84,20291,545,211
9/23/2021,Utah,2763885,80,20371,538,216
9/24/2021,Utah,2763885,81,20452,560,208
9/25/2021,Utah,2763885,90,20542,553,210
9/26/2021,Utah,2763885,71,20613,540,207
9/27/2021,Utah,2763885,70,20683,546,215
9/28/2021,Utah,2763885,82,20765,546,208
9/29/2021,Utah,2763885,85,20850,546,204
9/30/2021,Utah,2763885,86,20936,568,209
10/1/2021,Utah,2763885,74,21010,550,212
10/2/2021,Utah,2763885,70,21080,471,170
10/3/2021,Utah,2763885,67,21147,528,208
10/4/2021,Utah,2763885,75,21222,553,217
10/5/2021,Utah,2763885,85,21307,554,218
10/6/2021,Utah,2763885,65,21372,549,228
10/7/2021,Utah,2763885,84,21456,553,223
10/8/2021,Utah,2763885,99,21555,562,217
10/9/2021,Utah,2763885,100,21655,562,212
10/10/2021,Utah,2763885,70,21725,554,219
10/11/2021,Utah,2763885,68,21793,560,213
10/12/2021,Utah,2763885,70,21863,542,202
10/13/2021,Utah,2763885,75,21938,536,198
10/14/2021,Utah,2763885,77,22015,526,199
10/15/2021,Utah,2763885,68,22083,514,193
10/16/2021,Utah,2763885,75,22158,500,184
10/17/2021,Utah,2763885,68,22226,497,186
10/18/2021,Utah,2763885,69,22295,502,188
10/19/2021,Utah,2763885,84,22379,504,185
10/20/2021,Utah,2763885,75,22454,220,182
10/21/2021,Utah,2763885,87,22541,214,179
10/22/2021,Utah,2763885,78,22619,211,179
10/23/2021,Utah,2763885,71,22690,505,183
10/24/2021,Utah,2763885,65,22755,494,185
10/25/2021,Utah,2763885,75,22830,498,192
10/26/2021,Utah,2763885,84,22914,505,187
10/27/2021,Utah,2763885,77,22991,493,186
10/28/2021,Utah,2763885,86,23077,503,195
10/29/2021,Utah,2763885,69,23146,484,195
10/30/2021,Utah,2763885,89,23235,491,188
10/31/2021,Utah,2763885,69,23304,486,189
11/1/2021,Utah,2763885,66,23370,483,188
11/2/2021,Utah,2763885,102,23472,497,203
11/3/2021,Utah,2763885,88,23560,519,201
11/4/2021,Utah,2763885,84,23644,518,188
11/5/2021,Utah,2763885,86,23730,510,181
11/6/2021,Utah,2763885,98,23828,527,197
11/7/2021,Utah,2763885,83,23911,531,197
11/8/2021,Utah,2763885,70,23981,543,210
11/9/2021,Utah,2763885,82,24063,536,209
11/10/2021,Utah,2763885,70,24133,520,202
11/11/2021,Utah,2763885,76,24209,496,201
11/12/2021,Utah,2763885,91,24300,510,204
11/13/2021,Utah,2763885,66,24366,495,199
11/14/2021,Utah,2763885,83,24449,525,200
11/15/2021,Utah,2763885,76,24525,515,198
11/16/2021,Utah,2763885,89,24614,524,199
11/17/2021,Utah,2763885,75,24689,508,196
11/18/2021,Utah,2763885,63,24752,481,186
11/19/2021,Utah,2763885,61,24813,472,182
11/20/2021,Utah,2763885,68,24881,464,180
11/21/2021,Utah,2763885,67,24948,484,188
11/22/2021,Utah,2763885,73,25021,493,189
11/23/2021,Utah,2763885,74,25095,486,181
11/24/2021,Utah,2763885,73,25168,474,180
11/25/2021,Utah,2763885,87,25255,457,184
11/26/2021,Utah,2763885,48,25303,459,190
11/27/2021,Utah,2763885,62,25365,456,189
11/28/2021,Utah,2763885,60,25425,460,184
11/29/2021,Utah,2763885,61,25486,469,189
11/30/2021,Utah,2763885,83,25569,486,190
12/1/2021,Utah,2763885,80,25649,487,194
12/2/2021,Utah,2763885,78,25727,459,185
12/3/2021,Utah,2763885,82,25809,466,182
12/4/2021,Utah,2763885,71,25880,458,184
12/5/2021,Utah,2763885,72,25952,476,193
12/6/2021,Utah,2763885,54,26006,468,189
12/7/2021,Utah,2763885,78,26084,474,183
12/8/2021,Utah,2763885,77,26161,506,195
12/9/2021,Utah,2763885,70,26231,499,194
12/10/2021,Utah,2763885,60,26291,479,196
12/11/2021,Utah,2763885,74,26365,473,198
12/12/2021,Utah,2763885,56,26421,469,193
12/13/2021,Utah,2763885,65,26486,482,194
12/14/2021,Utah,2763885,78,26564,481,191
12/15/2021,Utah,2763885,62,26626,464,174
12/16/2021,Utah,2763885,83,26709,469,176
12/17/2021,Utah,2763885,49,26758,440,167
12/18/2021,Utah,2763885,58,26816,423,172
12/19/2021,Utah,2763885,46,26862,404,168
12/20/2021,Utah,2763885,46,26908,402,161
12/21/2021,Utah,2763885,72,26980,403,153
12/22/2021,Utah,2763885,66,27046,390,146
12/23/2021,Utah,2763885,65,27111,367,145
12/24/2021,Utah,2763885,60,27171,363,131
12/25/2021,Utah,2763885,71,27242,377,139
12/26/2021,Utah,2763885,58,27300,382,146
12/27/2021,Utah,2763885,55,27355,399,145
12/28/2021,Utah,2763885,80,27435,412,156
12/29/2021,Utah,2763885,67,27502,410,160
12/30/2021,Utah,2763885,75,27577,411,153
12/31/2021,Utah,2763885,87,27664,421,157
1/1/2022,Utah,2763885,59,27723,413,167
1/2/2022,Utah,2763885,60,27783,423,168
1/3/2022,Utah,2763885,83,27866,446,167
1/4/2022,Utah,2763885,114,27980,483,174
1/5/2022,Utah,2763885,118,28098,515,179
1/6/2022,Utah,2763885,35,28133,539,184
1/7/2022,Utah,2763885,112,28245,535,183
1/8/2022,Utah,2763885,126,28371,543,178
1/9/2022,Utah,2763885,86,28457,541,175
1/10/2022,Utah,2763885,104,28561,538,181
1/11/2022,Utah,2763885,139,28700,571,193
1/12/2022,Utah,2763885,161,28861,616,189
1/13/2022,Utah,2763885,139,29000,648,182
1/14/2022,Utah,2763885,142,29142,644,181
1/15/2022,Utah,2763885,149,29291,661,183
1/16/2022,Utah,2763885,120,29411,645,174
1/17/2022,Utah,2763885,156,29567,663,185
1/18/2022,Utah,2763885,175,29742,688,190
1/19/2022,Utah,2763885,176,29918,730,197
1/20/2022,Utah,2763885,175,30093,741,205
1/21/2022,Utah,2763885,176,30269,745,207
1/22/2022,Utah,2763885,195,30464,752,202
1/23/2022,Utah,2763885,133,30597,728,189
1/24/2022,Utah,2763885,144,30741,706,181
1/25/2022,Utah,2763885,181,30922,730,190
1/26/2022,Utah,2763885,175,31097,747,184
1/27/2022,Utah,2763885,164,31261,773,183
1/28/2022,Utah,2763885,162,31423,756,178
1/29/2022,Utah,2763885,157,31580,716,172
1/30/2022,Utah,2763885,150,31730,713,172
1/31/2022,Utah,2763885,111,31841,697,168
2/1/2022,Utah,2763885,156,31997,693,177
2/2/2022,Utah,2763885,150,32147,732,188
2/3/2022,Utah,2763885,164,32311,748,174
2/4/2022,Utah,2763885,149,32460,712,172
2/5/2022,Utah,2763885,128,32588,673,167
2/6/2022,Utah,2763885,111,32699,669,158
2/7/2022,Utah,2763885,92,32791,627,155
2/8/2022,Utah,2763885,125,32916,615,146
2/9/2022,Utah,2763885,125,33041,615,146
7/1/2021,Virginia,8382993,24,41750,172,54
7/2/2021,Virginia,8382993,15,41765,167,54
7/3/2021,Virginia,8382993,21,41786,153,48
7/4/2021,Virginia,8382993,19,41805,143,48
7/5/2021,Virginia,8382993,25,41830,139,42
7/6/2021,Virginia,8382993,25,41855,158,48
7/7/2021,Virginia,8382993,23,41878,171,48
7/8/2021,Virginia,8382993,32,41910,172,53
7/9/2021,Virginia,8382993,31,41941,170,47
7/10/2021,Virginia,8382993,24,41965,169,51
7/11/2021,Virginia,8382993,24,41989,173,51
7/12/2021,Virginia,8382993,20,42009,171,52
7/13/2021,Virginia,8382993,33,42042,168,53
7/14/2021,Virginia,8382993,40,42082,180,54
7/15/2021,Virginia,8382993,42,42124,193,56
7/16/2021,Virginia,8382993,35,42159,207,57
7/17/2021,Virginia,8382993,34,42193,214,55
7/18/2021,Virginia,8382993,26,42219,219,61
7/19/2021,Virginia,8382993,46,42265,253,71
7/20/2021,Virginia,8382993,38,42303,270,74
7/21/2021,Virginia,8382993,50,42353,293,80
7/22/2021,Virginia,8382993,62,42415,316,78
7/23/2021,Virginia,8382993,44,42459,300,79
7/24/2021,Virginia,8382993,48,42507,305,83
7/25/2021,Virginia,8382993,47,42554,321,85
7/26/2021,Virginia,8382993,47,42601,330,91
7/27/2021,Virginia,8382993,56,42657,331,94
7/28/2021,Virginia,8382993,52,42709,341,91
7/29/2021,Virginia,8382993,56,42765,356,89
7/30/2021,Virginia,8382993,70,42835,380,90
7/31/2021,Virginia,8382993,79,42914,397,96
8/1/2021,Virginia,8382993,66,42980,448,114
8/2/2021,Virginia,8382993,86,43066,505,129
8/3/2021,Virginia,8382993,110,43176,549,141
8/4/2021,Virginia,8382993,78,43254,577,141
8/5/2021,Virginia,8382993,86,43340,594,156
8/6/2021,Virginia,8382993,77,43417,607,156
8/7/2021,Virginia,8382993,88,43505,631,161
8/8/2021,Virginia,8382993,97,43602,661,176
8/9/2021,Virginia,8382993,107,43709,726,201
8/10/2021,Virginia,8382993,136,43845,788,208
8/11/2021,Virginia,8382993,137,43982,840,211
8/12/2021,Virginia,8382993,123,44105,877,232
8/13/2021,Virginia,8382993,157,44262,924,250
8/14/2021,Virginia,8382993,143,44405,966,274
8/15/2021,Virginia,8382993,124,44529,987,277
8/16/2021,Virginia,8382993,127,44656,1032,281
8/17/2021,Virginia,8382993,133,44789,1102,304
8/18/2021,Virginia,8382993,185,44974,1167,315
8/19/2021,Virginia,8382993,148,45122,1161,317
8/20/2021,Virginia,8382993,175,45297,1190,326
8/21/2021,Virginia,8382993,141,45438,1174,320
8/22/2021,Virginia,8382993,159,45597,1203,327
8/23/2021,Virginia,8382993,148,45745,1276,340
8/24/2021,Virginia,8382993,178,45923,1288,335
8/25/2021,Virginia,8382993,185,46108,1327,348
8/26/2021,Virginia,8382993,207,46315,1382,364
8/27/2021,Virginia,8382993,211,46526,1424,345
8/28/2021,Virginia,8382993,189,46715,1447,360
8/29/2021,Virginia,8382993,153,46868,1485,375
8/30/2021,Virginia,8382993,199,47067,1589,376
8/31/2021,Virginia,8382993,217,47284,1619,380
9/1/2021,Virginia,8382993,219,47503,1631,408
9/2/2021,Virginia,8382993,218,47721,1675,410
9/3/2021,Virginia,8382993,201,47922,1707,423
9/4/2021,Virginia,8382993,188,48110,1691,420
9/5/2021,Virginia,8382993,199,48309,1729,434
9/6/2021,Virginia,8382993,207,48516,1800,438
9/7/2021,Virginia,8382993,254,48770,1898,456
9/8/2021,Virginia,8382993,237,49007,1897,453
9/9/2021,Virginia,8382993,211,49218,1862,467
9/10/2021,Virginia,8382993,229,49447,1835,480
9/11/2021,Virginia,8382993,188,49635,1796,489
9/12/2021,Virginia,8382993,210,49845,1812,493
9/13/2021,Virginia,8382993,196,50041,1876,497
9/14/2021,Virginia,8382993,217,50258,1853,493
9/15/2021,Virginia,8382993,238,50496,1874,477
9/16/2021,Virginia,8382993,232,50728,1872,465
9/17/2021,Virginia,8382993,235,50963,1899,479
9/18/2021,Virginia,8382993,228,51191,1831,470
9/19/2021,Virginia,8382993,208,51399,1833,470
9/20/2021,Virginia,8382993,183,51582,1934,475
9/21/2021,Virginia,8382993,207,51789,1890,484
9/22/2021,Virginia,8382993,230,52019,1903,503
9/23/2021,Virginia,8382993,216,52235,1877,485
9/24/2021,Virginia,8382993,226,52461,1854,468
9/25/2021,Virginia,8382993,203,52664,1826,473
9/26/2021,Virginia,8382993,199,52863,1815,502
9/27/2021,Virginia,8382993,210,53073,1883,503
9/28/2021,Virginia,8382993,173,53246,1782,481
9/29/2021,Virginia,8382993,163,53409,1728,464
9/30/2021,Virginia,8382993,194,53603,1693,431
10/1/2021,Virginia,8382993,198,53801,1656,426
10/2/2021,Virginia,8382993,168,53969,1577,415
10/3/2021,Virginia,8382993,142,54111,1580,406
10/4/2021,Virginia,8382993,147,54258,1612,407
10/5/2021,Virginia,8382993,198,54456,1585,407
10/6/2021,Virginia,8382993,182,54638,1587,415
10/7/2021,Virginia,8382993,159,54797,1552,414
10/8/2021,Virginia,8382993,144,54941,1496,409
10/9/2021,Virginia,8382993,154,55095,1449,394
10/10/2021,Virginia,8382993,118,55213,1413,387
10/11/2021,Virginia,8382993,164,55377,1426,390
10/12/2021,Virginia,8382993,174,55551,1424,383
10/13/2021,Virginia,8382993,146,55697,1377,359
10/14/2021,Virginia,8382993,146,55843,1347,353
10/15/2021,Virginia,8382993,142,55985,1312,346
10/16/2021,Virginia,8382993,141,56126,1287,341
10/17/2021,Virginia,8382993,130,56256,1291,341
10/18/2021,Virginia,8382993,116,56372,1306,333
10/19/2021,Virginia,8382993,111,56483,1200,301
10/20/2021,Virginia,8382993,114,56597,1173,282
10/21/2021,Virginia,8382993,123,56720,1136,271
10/22/2021,Virginia,8382993,129,56849,1155,272
10/23/2021,Virginia,8382993,127,56976,1132,274
10/24/2021,Virginia,8382993,109,57085,1135,279
10/25/2021,Virginia,8382993,92,57177,1117,289
10/26/2021,Virginia,8382993,113,57290,1066,289
10/27/2021,Virginia,8382993,102,57392,1051,287
10/28/2021,Virginia,8382993,109,57501,972,286
10/29/2021,Virginia,8382993,98,57599,931,266
10/30/2021,Virginia,8382993,94,57693,918,263
10/31/2021,Virginia,8382993,81,57774,891,262
11/1/2021,Virginia,8382993,84,57858,915,263
11/2/2021,Virginia,8382993,95,57953,894,251
11/3/2021,Virginia,8382993,93,58046,872,237
11/4/2021,Virginia,8382993,92,58138,850,224
11/5/2021,Virginia,8382993,75,58213,811,205
11/6/2021,Virginia,8382993,91,58304,775,205
11/7/2021,Virginia,8382993,88,58392,762,203
11/8/2021,Virginia,8382993,89,58481,787,200
11/9/2021,Virginia,8382993,98,58579,797,207
11/10/2021,Virginia,8382993,91,58670,812,201
11/11/2021,Virginia,8382993,90,58760,792,202
11/12/2021,Virginia,8382993,92,58852,790,193
11/13/2021,Virginia,8382993,83,58935,760,214
11/14/2021,Virginia,8382993,77,59012,763,215
11/15/2021,Virginia,8382993,77,59089,777,188
11/16/2021,Virginia,8382993,76,59165,774,191
11/17/2021,Virginia,8382993,87,59252,754,194
11/18/2021,Virginia,8382993,83,59335,743,179
11/19/2021,Virginia,8382993,87,59422,754,191
11/20/2021,Virginia,8382993,94,59516,755,200
11/21/2021,Virginia,8382993,84,59600,755,205
11/22/2021,Virginia,8382993,117,59717,792,222
11/23/2021,Virginia,8382993,113,59830,797,218
11/24/2021,Virginia,8382993,88,59918,801,219
11/25/2021,Virginia,8382993,120,60038,811,226
11/26/2021,Virginia,8382993,81,60119,825,219
11/27/2021,Virginia,8382993,102,60221,832,220
11/28/2021,Virginia,8382993,88,60309,849,221
11/29/2021,Virginia,8382993,115,60424,892,224
11/30/2021,Virginia,8382993,118,60542,904,231
12/1/2021,Virginia,8382993,108,60650,907,233
12/2/2021,Virginia,8382993,113,60763,940,237
12/3/2021,Virginia,8382993,137,60900,972,243
12/4/2021,Virginia,8382993,161,61061,990,245
12/5/2021,Virginia,8382993,128,61189,992,255
12/6/2021,Virginia,8382993,144,61333,1046,254
12/7/2021,Virginia,8382993,198,61531,1111,252
12/8/2021,Virginia,8382993,136,61667,1107,244
12/9/2021,Virginia,8382993,158,61825,1154,263
12/10/2021,Virginia,8382993,176,62001,1168,282
12/11/2021,Virginia,8382993,145,62146,1171,292
12/12/2021,Virginia,8382993,143,62289,1199,291
12/13/2021,Virginia,8382993,126,62415,1234,310
12/14/2021,Virginia,8382993,168,62583,1244,317
12/15/2021,Virginia,8382993,158,62741,1295,336
12/16/2021,Virginia,8382993,166,62907,1298,338
12/17/2021,Virginia,8382993,187,63094,1320,335
12/18/2021,Virginia,8382993,165,63259,1290,341
12/19/2021,Virginia,8382993,130,63389,1310,344
12/20/2021,Virginia,8382993,161,63550,1372,346
12/21/2021,Virginia,8382993,193,63743,1424,369
12/22/2021,Virginia,8382993,183,63926,1424,364
12/23/2021,Virginia,8382993,221,64147,1466,367
12/24/2021,Virginia,8382993,196,64343,1489,363
12/25/2021,Virginia,8382993,165,64508,1490,374
12/26/2021,Virginia,8382993,218,64726,1561,356
12/27/2021,Virginia,8382993,254,64980,1710,412
12/28/2021,Virginia,8382993,317,65297,1816,397
12/29/2021,Virginia,8382993,344,65641,1982,380
12/30/2021,Virginia,8382993,371,66012,2067,423
12/31/2021,Virginia,8382993,413,66425,2169,437
1/1/2022,Virginia,8382993,360,66785,2246,458
1/2/2022,Virginia,8382993,368,67153,2360,446
1/3/2022,Virginia,8382993,408,67561,2625,485
1/4/2022,Virginia,8382993,415,67976,2688,495
1/5/2022,Virginia,8382993,495,68471,2856,514
1/6/2022,Virginia,8382993,564,69035,3118,542
1/7/2022,Virginia,8382993,537,69572,3293,549
1/8/2022,Virginia,8382993,481,70053,3330,547
1/9/2022,Virginia,8382993,469,70522,3525,564
1/10/2022,Virginia,8382993,462,70984,3617,602
1/11/2022,Virginia,8382993,500,71484,3692,633
1/12/2022,Virginia,8382993,483,71967,3694,621
1/13/2022,Virginia,8382993,469,72436,3652,636
1/14/2022,Virginia,8382993,503,72939,3745,637
1/15/2022,Virginia,8382993,469,73408,3645,645
1/16/2022,Virginia,8382993,381,73789,3659,629
1/17/2022,Virginia,8382993,359,74148,3703,631
1/18/2022,Virginia,8382993,441,74589,3725,628
1/19/2022,Virginia,8382993,495,75084,3684,635
1/20/2022,Virginia,8382993,531,75615,3662,627
1/21/2022,Virginia,8382993,487,76102,3551,613
1/22/2022,Virginia,8382993,404,76506,3346,589
1/23/2022,Virginia,8382993,368,76874,3333,589
1/24/2022,Virginia,8382993,368,77242,3415,586
1/25/2022,Virginia,8382993,427,77669,3307,590
1/26/2022,Virginia,8382993,425,78094,3215,572
1/27/2022,Virginia,8382993,359,78453,3112,562
1/28/2022,Virginia,8382993,343,78796,2956,557
1/29/2022,Virginia,8382993,369,79165,2892,526
1/30/2022,Virginia,8382993,295,79460,2863,534
1/31/2022,Virginia,8382993,263,79723,2833,522
2/1/2022,Virginia,8382993,345,80068,2659,511
2/2/2022,Virginia,8382993,262,80330,2518,486
2/3/2022,Virginia,8382993,321,80651,2431,480
2/4/2022,Virginia,8382993,282,80933,2329,467
2/5/2022,Virginia,8382993,297,81230,2227,447
2/6/2022,Virginia,8382993,223,81453,2145,431
2/7/2022,Virginia,8382993,190,81643,2149,434
2/8/2022,Virginia,8382993,255,81898,2089,407
2/9/2022,Virginia,8382993,254,82152,2082,404
7/1/2021,Virgin Islands,104901,0,99,3,1
7/2/2021,Virgin Islands,104901,1,100,4,1
7/3/2021,Virgin Islands,104901,0,100,5,2
7/4/2021,Virgin Islands,104901,1,101,4,2
7/5/2021,Virgin Islands,104901,2,103,4,2
7/6/2021,Virgin Islands,104901,0,103,3,2
7/7/2021,Virgin Islands,104901,1,104,5,3
7/8/2021,Virgin Islands,104901,0,104,5,2
7/9/2021,Virgin Islands,104901,0,104,5,2
7/10/2021,Virgin Islands,104901,0,104,5,2
7/11/2021,Virgin Islands,104901,1,105,7,1
7/12/2021,Virgin Islands,104901,3,108,10,2
7/13/2021,Virgin Islands,104901,1,109,11,2
7/14/2021,Virgin Islands,104901,0,109,11,2
7/15/2021,Virgin Islands,104901,1,110,12,2
7/16/2021,Virgin Islands,104901,2,112,14,3
7/17/2021,Virgin Islands,104901,3,115,16,3
7/18/2021,Virgin Islands,104901,0,115,15,3
7/19/2021,Virgin Islands,104901,0,115,15,3
7/20/2021,Virgin Islands,104901,1,116,16,3
7/21/2021,Virgin Islands,104901,1,117,18,3
7/22/2021,Virgin Islands,104901,4,121,17,3
7/23/2021,Virgin Islands,104901,1,122,19,3
7/24/2021,Virgin Islands,104901,0,122,20,4
7/25/2021,Virgin Islands,104901,0,122,21,4
7/26/2021,Virgin Islands,104901,0,122,16,5
7/27/2021,Virgin Islands,104901,0,122,19,7
7/28/2021,Virgin Islands,104901,0,122,16,4
7/29/2021,Virgin Islands,104901,3,125,19,7
7/30/2021,Virgin Islands,104901,0,125,18,6
7/31/2021,Virgin Islands,104901,2,127,21,6
8/1/2021,Virgin Islands,104901,1,128,24,6
8/2/2021,Virgin Islands,104901,0,128,26,6
8/3/2021,Virgin Islands,104901,0,128,27,7
8/4/2021,Virgin Islands,104901,0,128,31,7
8/5/2021,Virgin Islands,104901,3,131,31,6
8/6/2021,Virgin Islands,104901,2,133,31,6
8/7/2021,Virgin Islands,104901,1,134,26,5
8/8/2021,Virgin Islands,104901,0,134,24,5
8/9/2021,Virgin Islands,104901,1,135,27,5
8/10/2021,Virgin Islands,104901,2,137,33,5
8/11/2021,Virgin Islands,104901,4,141,38,5
8/12/2021,Virgin Islands,104901,3,144,40,5
8/13/2021,Virgin Islands,104901,3,147,39,5
8/14/2021,Virgin Islands,104901,1,148,38,4
8/15/2021,Virgin Islands,104901,1,149,38,5
8/16/2021,Virgin Islands,104901,1,150,36,6
8/17/2021,Virgin Islands,104901,1,151,34,5
8/18/2021,Virgin Islands,104901,1,152,35,6
8/19/2021,Virgin Islands,104901,0,152,33,6
8/20/2021,Virgin Islands,104901,0,152,33,6
8/21/2021,Virgin Islands,104901,0,152,23,7
8/22/2021,Virgin Islands,104901,0,152,24,7
8/23/2021,Virgin Islands,104901,2,154,21,6
8/24/2021,Virgin Islands,104901,1,155,18,7
8/25/2021,Virgin Islands,104901,0,155,14,7
8/26/2021,Virgin Islands,104901,0,155,15,8
8/27/2021,Virgin Islands,104901,0,155,19,8
8/28/2021,Virgin Islands,104901,0,155,16,7
8/29/2021,Virgin Islands,104901,0,155,16,7
8/30/2021,Virgin Islands,104901,0,155,15,7
8/31/2021,Virgin Islands,104901,0,155,13,5
9/1/2021,Virgin Islands,104901,1,156,14,3
9/2/2021,Virgin Islands,104901,0,156,13,5
9/3/2021,Virgin Islands,104901,0,156,11,4
9/4/2021,Virgin Islands,104901,0,156,7,2
9/5/2021,Virgin Islands,104901,1,157,8,2
9/6/2021,Virgin Islands,104901,0,157,8,2
9/7/2021,Virgin Islands,104901,1,158,8,4
9/8/2021,Virgin Islands,104901,0,158,5,1
9/9/2021,Virgin Islands,104901,2,160,7,2
9/10/2021,Virgin Islands,104901,0,160,6,1
9/11/2021,Virgin Islands,104901,1,161,6,1
9/12/2021,Virgin Islands,104901,1,162,6,2
9/13/2021,Virgin Islands,104901,0,162,4,2
9/14/2021,Virgin Islands,104901,2,164,6,2
9/15/2021,Virgin Islands,104901,3,167,8,1
9/16/2021,Virgin Islands,104901,0,167,6,2
9/17/2021,Virgin Islands,104901,0,167,5,3
9/18/2021,Virgin Islands,104901,0,167,5,1
9/19/2021,Virgin Islands,104901,0,167,4,0
9/20/2021,Virgin Islands,104901,0,167,5,1
9/21/2021,Virgin Islands,104901,1,168,7,2
9/22/2021,Virgin Islands,104901,1,169,6,1
9/23/2021,Virgin Islands,104901,1,170,6,2
9/24/2021,Virgin Islands,104901,0,170,6,4
9/25/2021,Virgin Islands,104901,0,170,5,3
9/26/2021,Virgin Islands,104901,0,170,6,4
9/27/2021,Virgin Islands,104901,1,171,5,1
9/28/2021,Virgin Islands,104901,0,171,6,2
9/29/2021,Virgin Islands,104901,2,173,7,3
9/30/2021,Virgin Islands,104901,2,175,9,3
10/1/2021,Virgin Islands,104901,2,177,10,3
10/2/2021,Virgin Islands,104901,0,177,10,3
10/3/2021,Virgin Islands,104901,0,177,9,2
10/4/2021,Virgin Islands,104901,0,177,8,2
10/5/2021,Virgin Islands,104901,0,177,7,2
10/6/2021,Virgin Islands,104901,0,177,7,3
10/7/2021,Virgin Islands,104901,2,179,9,9
10/8/2021,Virgin Islands,104901,1,180,9,9
10/9/2021,Virgin Islands,104901,0,180,8,3
10/10/2021,Virgin Islands,104901,0,180,9,3
10/11/2021,Virgin Islands,104901,1,181,8,2
10/12/2021,Virgin Islands,104901,0,181,8,2
10/13/2021,Virgin Islands,104901,0,181,7,2
10/14/2021,Virgin Islands,104901,0,181,5,2
10/15/2021,Virgin Islands,104901,1,182,4,2
10/16/2021,Virgin Islands,104901,0,182,4,2
10/17/2021,Virgin Islands,104901,0,182,4,2
10/18/2021,Virgin Islands,104901,0,182,3,2
10/19/2021,Virgin Islands,104901,0,182,3,2
10/20/2021,Virgin Islands,104901,2,184,5,3
10/21/2021,Virgin Islands,104901,1,185,6,3
10/22/2021,Virgin Islands,104901,1,186,7,3
10/23/2021,Virgin Islands,104901,0,186,6,3
10/24/2021,Virgin Islands,104901,1,187,7,3
10/25/2021,Virgin Islands,104901,0,187,2,2
10/26/2021,Virgin Islands,104901,2,189,4,2
10/27/2021,Virgin Islands,104901,0,189,4,1
10/28/2021,Virgin Islands,104901,1,190,5,1
10/29/2021,Virgin Islands,104901,0,190,3,1
10/30/2021,Virgin Islands,104901,0,190,3,1
10/31/2021,Virgin Islands,104901,0,190,2,1
11/1/2021,Virgin Islands,104901,0,190,1,1
11/2/2021,Virgin Islands,104901,1,191,2,2
11/3/2021,Virgin Islands,104901,1,192,4,2
11/4/2021,Virgin Islands,104901,0,192,2,1
11/5/2021,Virgin Islands,104901,0,192,2,1
11/6/2021,Virgin Islands,104901,0,192,3,1
11/7/2021,Virgin Islands,104901,0,192,2,1
11/8/2021,Virgin Islands,104901,1,193,3,1
11/9/2021,Virgin Islands,104901,0,193,2,1
11/10/2021,Virgin Islands,104901,0,193,0,0
11/11/2021,Virgin Islands,104901,0,193,0,0
11/12/2021,Virgin Islands,104901,0,193,0,0
11/13/2021,Virgin Islands,104901,0,193,0,0
11/14/2021,Virgin Islands,104901,1,194,1,0
11/15/2021,Virgin Islands,104901,1,195,2,0
11/16/2021,Virgin Islands,104901,0,195,2,0
11/17/2021,Virgin Islands,104901,1,196,3,0
11/18/2021,Virgin Islands,104901,1,197,4,1
11/19/2021,Virgin Islands,104901,1,198,5,1
11/20/2021,Virgin Islands,104901,0,198,4,0
11/21/2021,Virgin Islands,104901,0,198,4,0
11/22/2021,Virgin Islands,104901,0,198,1,0
11/23/2021,Virgin Islands,104901,0,198,0,0
11/24/2021,Virgin Islands,104901,1,199,1,0
11/25/2021,Virgin Islands,104901,0,199,1,0
11/26/2021,Virgin Islands,104901,0,199,1,0
11/27/2021,Virgin Islands,104901,1,200,2,0
11/28/2021,Virgin Islands,104901,0,200,2,0
11/29/2021,Virgin Islands,104901,0,200,2,0
11/30/2021,Virgin Islands,104901,0,200,1,0
12/1/2021,Virgin Islands,104901,0,200,1,0
12/2/2021,Virgin Islands,104901,1,201,2,0
12/3/2021,Virgin Islands,104901,0,201,1,0
12/4/2021,Virgin Islands,104901,0,201,1,0
12/5/2021,Virgin Islands,104901,1,202,2,0
12/6/2021,Virgin Islands,104901,0,202,2,0
12/7/2021,Virgin Islands,104901,0,202,2,0
12/8/2021,Virgin Islands,104901,1,203,2,0
12/9/2021,Virgin Islands,104901,0,203,2,0
12/10/2021,Virgin Islands,104901,0,203,2,0
12/11/2021,Virgin Islands,104901,0,203,2,0
12/12/2021,Virgin Islands,104901,0,203,2,0
12/13/2021,Virgin Islands,104901,0,203,1,0
12/14/2021,Virgin Islands,104901,2,205,3,0
12/15/2021,Virgin Islands,104901,1,206,3,0
12/16/2021,Virgin Islands,104901,0,206,3,0
12/17/2021,Virgin Islands,104901,0,206,3,0
12/18/2021,Virgin Islands,104901,0,206,2,0
12/19/2021,Virgin Islands,104901,0,206,2,0
12/20/2021,Virgin Islands,104901,0,206,1,0
12/21/2021,Virgin Islands,104901,0,206,0,0
12/22/2021,Virgin Islands,104901,1,207,1,0
12/23/2021,Virgin Islands,104901,0,207,1,0
12/24/2021,Virgin Islands,104901,2,209,2,0
12/25/2021,Virgin Islands,104901,1,210,3,0
12/26/2021,Virgin Islands,104901,2,212,4,1
12/27/2021,Virgin Islands,104901,0,212,3,0
12/28/2021,Virgin Islands,104901,1,213,4,0
12/29/2021,Virgin Islands,104901,0,213,10,2
12/30/2021,Virgin Islands,104901,3,216,11,1
12/31/2021,Virgin Islands,104901,1,217,10,0
1/1/2022,Virgin Islands,104901,3,220,12,0
1/2/2022,Virgin Islands,104901,1,221,8,0
1/3/2022,Virgin Islands,104901,1,222,8,1
1/4/2022,Virgin Islands,104901,1,223,11,1
1/5/2022,Virgin Islands,104901,4,227,13,3
1/6/2022,Virgin Islands,104901,6,233,18,3
1/7/2022,Virgin Islands,104901,2,235,19,2
1/8/2022,Virgin Islands,104901,0,235,20,2
1/9/2022,Virgin Islands,104901,2,237,21,4
1/10/2022,Virgin Islands,104901,5,242,25,2
1/11/2022,Virgin Islands,104901,3,245,26,4
1/12/2022,Virgin Islands,104901,2,247,23,4
1/13/2022,Virgin Islands,104901,0,247,18,2
1/14/2022,Virgin Islands,104901,2,249,18,2
1/15/2022,Virgin Islands,104901,2,251,18,4
1/16/2022,Virgin Islands,104901,3,254,19,3
1/17/2022,Virgin Islands,104901,6,260,25,2
1/18/2022,Virgin Islands,104901,2,262,26,3
1/19/2022,Virgin Islands,104901,0,262,25,3
1/20/2022,Virgin Islands,104901,9,271,31,3
1/21/2022,Virgin Islands,104901,7,278,32,6
1/22/2022,Virgin Islands,104901,5,283,29,5
1/23/2022,Virgin Islands,104901,2,285,25,5
1/24/2022,Virgin Islands,104901,1,286,23,5
1/25/2022,Virgin Islands,104901,3,289,25,8
1/26/2022,Virgin Islands,104901,4,293,24,8
1/27/2022,Virgin Islands,104901,5,298,24,6
1/28/2022,Virgin Islands,104901,4,302,25,4
1/29/2022,Virgin Islands,104901,2,304,25,3
1/30/2022,Virgin Islands,104901,0,304,25,5
1/31/2022,Virgin Islands,104901,0,304,20,3
2/1/2022,Virgin Islands,104901,0,304,20,4
2/2/2022,Virgin Islands,104901,2,306,21,4
2/3/2022,Virgin Islands,104901,2,308,21,4
2/4/2022,Virgin Islands,104901,0,308,19,4
2/5/2022,Virgin Islands,104901,0,308,17,4
2/6/2022,Virgin Islands,104901,1,309,17,4
2/7/2022,Virgin Islands,104901,0,309,17,4
2/8/2022,Virgin Islands,104901,1,310,14,4
2/9/2022,Virgin Islands,104901,1,311,14,4
7/1/2021,Vermont,626042,2,1179,5,2
7/2/2021,Vermont,626042,0,1179,4,2
7/3/2021,Vermont,626042,1,1180,6,1
7/4/2021,Vermont,626042,1,1181,5,1
7/5/2021,Vermont,626042,0,1181,5,1
7/6/2021,Vermont,626042,2,1183,6,2
7/7/2021,Vermont,626042,1,1184,4,1
7/8/2021,Vermont,626042,0,1184,3,1
7/9/2021,Vermont,626042,1,1185,5,1
7/10/2021,Vermont,626042,0,1185,6,1
7/11/2021,Vermont,626042,0,1185,6,1
7/12/2021,Vermont,626042,1,1186,5,1
7/13/2021,Vermont,626042,1,1187,6,1
7/14/2021,Vermont,626042,0,1187,4,1
7/15/2021,Vermont,626042,0,1187,3,1
7/16/2021,Vermont,626042,0,1187,3,1
7/17/2021,Vermont,626042,0,1187,2,1
7/18/2021,Vermont,626042,1,1188,3,1
7/19/2021,Vermont,626042,0,1188,2,1
7/20/2021,Vermont,626042,1,1189,2,1
7/21/2021,Vermont,626042,0,1189,0,0
7/22/2021,Vermont,626042,1,1190,1,1
7/23/2021,Vermont,626042,2,1192,3,1
7/24/2021,Vermont,626042,0,1192,3,0
7/25/2021,Vermont,626042,0,1192,3,0
7/26/2021,Vermont,626042,4,1196,5,0
7/27/2021,Vermont,626042,0,1196,6,0
7/28/2021,Vermont,626042,0,1196,5,0
7/29/2021,Vermont,626042,1,1197,3,0
7/30/2021,Vermont,626042,0,1197,3,0
7/31/2021,Vermont,626042,1,1198,3,1
8/1/2021,Vermont,626042,0,1198,3,1
8/2/2021,Vermont,626042,1,1199,4,0
8/3/2021,Vermont,626042,0,1199,4,2
8/4/2021,Vermont,626042,5,1204,10,4
8/5/2021,Vermont,626042,1,1205,12,7
8/6/2021,Vermont,626042,2,1207,13,9
8/7/2021,Vermont,626042,1,1208,15,8
8/8/2021,Vermont,626042,4,1212,18,10
8/9/2021,Vermont,626042,3,1215,21,9
8/10/2021,Vermont,626042,6,1221,25,10
8/11/2021,Vermont,626042,4,1225,24,8
8/12/2021,Vermont,626042,3,1228,26,9
8/13/2021,Vermont,626042,1,1229,26,8
8/14/2021,Vermont,626042,7,1236,27,9
8/15/2021,Vermont,626042,2,1238,26,10
8/16/2021,Vermont,626042,3,1241,28,11
8/17/2021,Vermont,626042,6,1247,25,10
8/18/2021,Vermont,626042,4,1251,28,9
8/19/2021,Vermont,626042,1,1252,23,10
8/20/2021,Vermont,626042,5,1257,26,13
8/21/2021,Vermont,626042,1,1258,24,10
8/22/2021,Vermont,626042,2,1260,25,10
8/23/2021,Vermont,626042,7,1267,33,11
8/24/2021,Vermont,626042,11,1278,35,15
8/25/2021,Vermont,626042,5,1283,34,11
8/26/2021,Vermont,626042,7,1290,33,8
8/27/2021,Vermont,626042,8,1298,29,8
8/28/2021,Vermont,626042,6,1304,33,8
8/29/2021,Vermont,626042,4,1308,29,7
8/30/2021,Vermont,626042,4,1312,33,10
8/31/2021,Vermont,626042,6,1318,28,9
9/1/2021,Vermont,626042,4,1322,29,8
9/2/2021,Vermont,626042,8,1330,28,8
9/3/2021,Vermont,626042,8,1338,30,11
9/4/2021,Vermont,626042,4,1342,33,10
9/5/2021,Vermont,626042,5,1347,29,11
9/6/2021,Vermont,626042,4,1351,33,12
9/7/2021,Vermont,626042,4,1355,35,13
9/8/2021,Vermont,626042,7,1362,33,8
9/9/2021,Vermont,626042,5,1367,33,9
9/10/2021,Vermont,626042,7,1374,32,10
9/11/2021,Vermont,626042,8,1382,32,11
9/12/2021,Vermont,626042,7,1389,31,9
9/13/2021,Vermont,626042,7,1396,38,10
9/14/2021,Vermont,626042,11,1407,40,11
9/15/2021,Vermont,626042,11,1418,41,11
9/16/2021,Vermont,626042,9,1427,44,12
9/17/2021,Vermont,626042,14,1441,45,14
9/18/2021,Vermont,626042,11,1452,44,15
9/19/2021,Vermont,626042,9,1461,43,13
9/20/2021,Vermont,626042,12,1473,49,16
9/21/2021,Vermont,626042,6,1479,48,20
9/22/2021,Vermont,626042,7,1486,47,15
9/23/2021,Vermont,626042,9,1495,43,16
9/24/2021,Vermont,626042,13,1508,43,17
9/25/2021,Vermont,626042,12,1520,42,15
9/26/2021,Vermont,626042,8,1528,37,8
9/27/2021,Vermont,626042,15,1543,44,15
9/28/2021,Vermont,626042,10,1553,45,13
9/29/2021,Vermont,626042,11,1564,45,13
9/30/2021,Vermont,626042,10,1574,46,11
10/1/2021,Vermont,626042,11,1585,51,11
10/2/2021,Vermont,626042,3,1588,43,13
10/3/2021,Vermont,626042,7,1595,46,12
10/4/2021,Vermont,626042,6,1601,43,15
10/5/2021,Vermont,626042,2,1603,39,15
10/6/2021,Vermont,626042,5,1608,34,12
10/7/2021,Vermont,626042,6,1614,35,8
10/8/2021,Vermont,626042,8,1622,31,9
10/9/2021,Vermont,626042,8,1630,33,10
10/10/2021,Vermont,626042,9,1639,32,11
10/11/2021,Vermont,626042,8,1647,42,13
10/12/2021,Vermont,626042,13,1660,49,17
10/13/2021,Vermont,626042,9,1669,46,16
10/14/2021,Vermont,626042,10,1679,49,21
10/15/2021,Vermont,626042,7,1686,46,14
10/16/2021,Vermont,626042,7,1693,43,14
10/17/2021,Vermont,626042,6,1699,40,13
10/18/2021,Vermont,626042,5,1704,44,13
10/19/2021,Vermont,626042,11,1715,45,18
10/20/2021,Vermont,626042,13,1728,58,20
10/21/2021,Vermont,626042,5,1733,49,18
10/22/2021,Vermont,626042,4,1737,50,12
10/23/2021,Vermont,626042,9,1746,45,13
10/24/2021,Vermont,626042,8,1754,44,10
10/25/2021,Vermont,626042,6,1760,51,16
10/26/2021,Vermont,626042,6,1766,55,17
10/27/2021,Vermont,626042,16,1782,57,16
10/28/2021,Vermont,626042,4,1786,59,17
10/29/2021,Vermont,626042,13,1799,58,17
10/30/2021,Vermont,626042,8,1807,51,16
10/31/2021,Vermont,626042,5,1812,45,10
11/1/2021,Vermont,626042,4,1816,48,10
11/2/2021,Vermont,626042,12,1828,50,16
11/3/2021,Vermont,626042,9,1837,53,18
11/4/2021,Vermont,626042,9,1846,55,20
11/5/2021,Vermont,626042,9,1855,46,16
11/6/2021,Vermont,626042,10,1865,41,14
11/7/2021,Vermont,626042,11,1876,46,16
11/8/2021,Vermont,626042,10,1886,57,20
11/9/2021,Vermont,626042,11,1897,60,20
11/10/2021,Vermont,626042,9,1906,55,18
11/11/2021,Vermont,626042,8,1914,58,15
11/12/2021,Vermont,626042,10,1924,55,13
11/13/2021,Vermont,626042,9,1933,46,13
11/14/2021,Vermont,626042,10,1943,52,9
11/15/2021,Vermont,626042,6,1949,57,19
11/16/2021,Vermont,626042,11,1960,61,18
11/17/2021,Vermont,626042,11,1971,66,19
11/18/2021,Vermont,626042,10,1981,64,15
11/19/2021,Vermont,626042,12,1993,66,17
11/20/2021,Vermont,626042,10,2003,63,15
11/21/2021,Vermont,626042,9,2012,58,13
11/22/2021,Vermont,626042,12,2024,59,18
11/23/2021,Vermont,626042,16,2040,70,17
11/24/2021,Vermont,626042,12,2052,68,20
11/25/2021,Vermont,626042,9,2061,67,20
11/26/2021,Vermont,626042,11,2072,68,22
11/27/2021,Vermont,626042,8,2080,66,21
11/28/2021,Vermont,626042,10,2090,68,22
11/29/2021,Vermont,626042,18,2108,89,23
11/30/2021,Vermont,626042,21,2129,86,20
12/1/2021,Vermont,626042,15,2144,85,22
12/2/2021,Vermont,626042,7,2151,79,23
12/3/2021,Vermont,626042,17,2168,85,22
12/4/2021,Vermont,626042,20,2188,79,21
12/5/2021,Vermont,626042,16,2204,84,22
12/6/2021,Vermont,626042,11,2215,82,25
12/7/2021,Vermont,626042,23,2238,94,32
12/8/2021,Vermont,626042,25,2263,96,29
12/9/2021,Vermont,626042,10,2273,88,24
12/10/2021,Vermont,626042,14,2287,82,25
12/11/2021,Vermont,626042,8,2295,80,23
12/12/2021,Vermont,626042,12,2307,78,21
12/13/2021,Vermont,626042,8,2315,82,21
12/14/2021,Vermont,626042,15,2330,86,24
12/15/2021,Vermont,626042,6,2336,73,22
12/16/2021,Vermont,626042,6,2342,66,21
12/17/2021,Vermont,626042,10,2352,67,21
12/18/2021,Vermont,626042,9,2361,62,19
12/19/2021,Vermont,626042,8,2369,62,20
12/20/2021,Vermont,626042,6,2375,60,21
12/21/2021,Vermont,626042,12,2387,59,19
12/22/2021,Vermont,626042,13,2400,59,19
12/23/2021,Vermont,626042,14,2414,55,18
12/24/2021,Vermont,626042,13,2427,59,16
12/25/2021,Vermont,626042,8,2435,57,15
12/26/2021,Vermont,626042,13,2448,61,15
12/27/2021,Vermont,626042,15,2463,62,15
12/28/2021,Vermont,626042,10,2473,55,15
12/29/2021,Vermont,626042,9,2482,54,18
12/30/2021,Vermont,626042,10,2492,57,19
12/31/2021,Vermont,626042,18,2510,68,22
1/1/2022,Vermont,626042,12,2522,68,17
1/2/2022,Vermont,626042,10,2532,69,15
1/3/2022,Vermont,626042,11,2543,75,14
1/4/2022,Vermont,626042,21,2564,84,19
1/5/2022,Vermont,626042,17,2581,93,15
1/6/2022,Vermont,626042,24,2605,98,17
1/7/2022,Vermont,626042,11,2616,89,14
1/8/2022,Vermont,626042,21,2637,97,17
1/9/2022,Vermont,626042,18,2655,96,19
1/10/2022,Vermont,626042,23,2678,108,21
1/11/2022,Vermont,626042,13,2691,97,21
1/12/2022,Vermont,626042,21,2712,93,27
1/13/2022,Vermont,626042,23,2735,100,28
1/14/2022,Vermont,626042,28,2763,109,25
1/15/2022,Vermont,626042,24,2787,111,27
1/16/2022,Vermont,626042,24,2811,124,26
1/17/2022,Vermont,626042,19,2830,112,24
1/18/2022,Vermont,626042,17,2847,125,26
1/19/2022,Vermont,626042,25,2872,122,25
1/20/2022,Vermont,626042,15,2887,118,27
1/21/2022,Vermont,626042,19,2906,110,27
1/22/2022,Vermont,626042,26,2932,113,25
1/23/2022,Vermont,626042,19,2951,107,27
1/24/2022,Vermont,626042,15,2966,108,24
1/25/2022,Vermont,626042,17,2983,100,23
1/26/2022,Vermont,626042,26,3009,117,24
1/27/2022,Vermont,626042,21,3030,109,27
1/28/2022,Vermont,626042,19,3049,109,25
1/29/2022,Vermont,626042,17,3066,109,22
1/30/2022,Vermont,626042,14,3080,104,25
1/31/2022,Vermont,626042,11,3091,98,26
2/1/2022,Vermont,626042,17,3108,99,26
2/2/2022,Vermont,626042,9,3117,94,23
2/3/2022,Vermont,626042,21,3138,96,23
2/4/2022,Vermont,626042,14,3152,97,21
2/5/2022,Vermont,626042,14,3166,100,20
2/6/2022,Vermont,626042,13,3179,96,16
2/7/2022,Vermont,626042,13,3192,91,21
2/8/2022,Vermont,626042,12,3204,88,20
2/9/2022,Vermont,626042,12,3216,88,20
7/1/2021,Washington,7170351,50,19434,302,95
7/2/2021,Washington,7170351,28,19462,312,111
7/3/2021,Washington,7170351,41,19503,289,90
7/4/2021,Washington,7170351,37,19540,286,87
7/5/2021,Washington,7170351,30,19570,277,83
7/6/2021,Washington,7170351,34,19604,269,84
7/7/2021,Washington,7170351,36,19640,275,85
7/8/2021,Washington,7170351,44,19684,294,85
7/9/2021,Washington,7170351,43,19727,293,82
7/10/2021,Washington,7170351,37,19764,293,77
7/11/2021,Washington,7170351,37,19801,293,80
7/12/2021,Washington,7170351,30,19831,296,86
7/13/2021,Washington,7170351,43,19874,300,92
7/14/2021,Washington,7170351,44,19918,303,88
7/15/2021,Washington,7170351,45,19963,317,90
7/16/2021,Washington,7170351,48,20011,328,100
7/17/2021,Washington,7170351,40,20051,344,100
7/18/2021,Washington,7170351,45,20096,346,106
7/19/2021,Washington,7170351,47,20143,320,106
7/20/2021,Washington,7170351,42,20185,324,105
7/21/2021,Washington,7170351,60,20245,331,108
7/22/2021,Washington,7170351,59,20304,328,111
7/23/2021,Washington,7170351,59,20363,355,110
7/24/2021,Washington,7170351,47,20410,385,115
7/25/2021,Washington,7170351,62,20472,412,123
7/26/2021,Washington,7170351,65,20537,422,122
7/27/2021,Washington,7170351,72,20609,464,139
7/28/2021,Washington,7170351,89,20698,500,146
7/29/2021,Washington,7170351,76,20774,519,156
7/30/2021,Washington,7170351,86,20860,547,165
7/31/2021,Washington,7170351,77,20937,556,163
8/1/2021,Washington,7170351,66,21003,567,173
8/2/2021,Washington,7170351,89,21092,604,196
8/3/2021,Washington,7170351,105,21197,644,205
8/4/2021,Washington,7170351,82,21279,655,203
8/5/2021,Washington,7170351,105,21384,708,220
8/6/2021,Washington,7170351,97,21481,730,216
8/7/2021,Washington,7170351,82,21563,742,219
8/8/2021,Washington,7170351,70,21633,769,222
8/9/2021,Washington,7170351,122,21755,853,233
8/10/2021,Washington,7170351,113,21868,892,233
8/11/2021,Washington,7170351,130,21998,921,257
8/12/2021,Washington,7170351,119,22117,972,282
8/13/2021,Washington,7170351,111,22228,1039,290
8/14/2021,Washington,7170351,116,22344,1071,305
8/15/2021,Washington,7170351,114,22458,1136,308
8/16/2021,Washington,7170351,142,22600,1134,325
8/17/2021,Washington,7170351,172,22772,1182,312
8/18/2021,Washington,7170351,130,22902,1210,326
8/19/2021,Washington,7170351,138,23040,1223,332
8/20/2021,Washington,7170351,155,23195,1269,338
8/21/2021,Washington,7170351,157,23352,1296,333
8/22/2021,Washington,7170351,127,23479,1300,349
8/23/2021,Washington,7170351,156,23635,1395,375
8/24/2021,Washington,7170351,180,23815,1443,385
8/25/2021,Washington,7170351,163,23978,1469,392
8/26/2021,Washington,7170351,158,24136,1499,393
8/27/2021,Washington,7170351,159,24295,1479,424
8/28/2021,Washington,7170351,176,24471,1559,416
8/29/2021,Washington,7170351,173,24644,1590,428
8/30/2021,Washington,7170351,152,24796,1624,438
8/31/2021,Washington,7170351,180,24976,1625,447
9/1/2021,Washington,7170351,188,25164,1624,448
9/2/2021,Washington,7170351,175,25339,1631,448
9/3/2021,Washington,7170351,178,25517,1607,448
9/4/2021,Washington,7170351,175,25692,1615,442
9/5/2021,Washington,7170351,191,25883,1652,457
9/6/2021,Washington,7170351,155,26038,1696,451
9/7/2021,Washington,7170351,165,26203,1656,424
9/8/2021,Washington,7170351,187,26390,1683,422
9/9/2021,Washington,7170351,189,26579,1708,443
9/10/2021,Washington,7170351,131,26710,1700,437
9/11/2021,Washington,7170351,143,26853,1669,433
9/12/2021,Washington,7170351,167,27020,1667,442
9/13/2021,Washington,7170351,145,27165,1656,433
9/14/2021,Washington,7170351,149,27314,1615,439
9/15/2021,Washington,7170351,152,27466,1629,433
9/16/2021,Washington,7170351,164,27630,1623,417
9/17/2021,Washington,7170351,146,27776,1569,418
9/18/2021,Washington,7170351,142,27918,1567,411
9/19/2021,Washington,7170351,113,28031,1553,399
9/20/2021,Washington,7170351,117,28148,1511,390
9/21/2021,Washington,7170351,171,28319,1472,378
9/22/2021,Washington,7170351,121,28440,1438,377
9/23/2021,Washington,7170351,109,28549,1402,360
9/24/2021,Washington,7170351,117,28666,1337,346
9/25/2021,Washington,7170351,126,28792,1322,347
9/26/2021,Washington,7170351,108,28900,1333,344
9/27/2021,Washington,7170351,132,29032,1280,320
9/28/2021,Washington,7170351,141,29173,1285,322
9/29/2021,Washington,7170351,118,29291,1273,329
9/30/2021,Washington,7170351,140,29431,1273,345
10/1/2021,Washington,7170351,114,29545,1236,351
10/2/2021,Washington,7170351,113,29658,1204,347
10/3/2021,Washington,7170351,96,29754,1188,348
10/4/2021,Washington,7170351,111,29865,1178,336
10/5/2021,Washington,7170351,113,29978,1196,324
10/6/2021,Washington,7170351,132,30110,1180,322
10/7/2021,Washington,7170351,115,30225,1183,314
10/8/2021,Washington,7170351,106,30331,1157,308
10/9/2021,Washington,7170351,105,30436,1131,305
10/10/2021,Washington,7170351,89,30525,1133,287
10/11/2021,Washington,7170351,112,30637,1147,297
10/12/2021,Washington,7170351,119,30756,1145,291
10/13/2021,Washington,7170351,113,30869,1124,277
10/14/2021,Washington,7170351,101,30970,1083,277
10/15/2021,Washington,7170351,107,31077,1073,288
10/16/2021,Washington,7170351,101,31178,1057,287
10/17/2021,Washington,7170351,97,31275,1066,278
10/18/2021,Washington,7170351,108,31383,1077,282
10/19/2021,Washington,7170351,87,31470,1067,278
10/20/2021,Washington,7170351,99,31569,1065,265
10/21/2021,Washington,7170351,91,31660,1053,254
10/22/2021,Washington,7170351,91,31751,1042,265
10/23/2021,Washington,7170351,97,31848,1038,265
10/24/2021,Washington,7170351,85,31933,1046,284
10/25/2021,Washington,7170351,104,32037,1086,294
10/26/2021,Washington,7170351,97,32134,1088,293
10/27/2021,Washington,7170351,128,32262,1086,283
10/28/2021,Washington,7170351,96,32358,1068,271
10/29/2021,Washington,7170351,77,32435,982,264
10/30/2021,Washington,7170351,102,32537,977,276
10/31/2021,Washington,7170351,67,32604,938,273
11/1/2021,Washington,7170351,95,32699,1007,298
11/2/2021,Washington,7170351,92,32791,978,283
11/3/2021,Washington,7170351,90,32881,977,276
11/4/2021,Washington,7170351,120,33001,961,273
11/5/2021,Washington,7170351,107,33108,974,281
11/6/2021,Washington,7170351,107,33215,963,273
11/7/2021,Washington,7170351,63,33278,948,257
11/8/2021,Washington,7170351,101,33379,923,246
11/9/2021,Washington,7170351,97,33476,918,246
11/10/2021,Washington,7170351,84,33560,880,238
11/11/2021,Washington,7170351,83,33643,842,231
11/12/2021,Washington,7170351,92,33735,785,214
11/13/2021,Washington,7170351,85,33820,806,222
11/14/2021,Washington,7170351,44,33864,803,213
11/15/2021,Washington,7170351,100,33964,864,231
11/16/2021,Washington,7170351,89,34053,854,233
11/17/2021,Washington,7170351,72,34125,824,212
11/18/2021,Washington,7170351,82,34207,834,217
11/19/2021,Washington,7170351,78,34285,773,206
11/20/2021,Washington,7170351,54,34339,745,197
11/21/2021,Washington,7170351,49,34388,732,199
11/22/2021,Washington,7170351,64,34452,720,207
11/23/2021,Washington,7170351,74,34526,701,212
11/24/2021,Washington,7170351,78,34604,691,198
11/25/2021,Washington,7170351,70,34674,695,197
11/26/2021,Washington,7170351,53,34727,671,192
11/27/2021,Washington,7170351,74,34801,695,186
11/28/2021,Washington,7170351,49,34850,696,196
11/29/2021,Washington,7170351,56,34906,689,196
11/30/2021,Washington,7170351,89,34995,683,195
12/1/2021,Washington,7170351,76,35071,687,202
12/2/2021,Washington,7170351,84,35155,682,204
12/3/2021,Washington,7170351,67,35222,690,190
12/4/2021,Washington,7170351,88,35310,722,200
12/5/2021,Washington,7170351,62,35372,707,198
12/6/2021,Washington,7170351,68,35440,669,191
12/7/2021,Washington,7170351,83,35523,665,203
12/8/2021,Washington,7170351,81,35604,661,187
12/9/2021,Washington,7170351,77,35681,651,178
12/10/2021,Washington,7170351,71,35752,642,177
12/11/2021,Washington,7170351,57,35809,626,172
12/12/2021,Washington,7170351,51,35860,628,175
12/13/2021,Washington,7170351,63,35923,641,169
12/14/2021,Washington,7170351,90,36013,627,159
12/15/2021,Washington,7170351,61,36074,629,164
12/16/2021,Washington,7170351,74,36148,636,165
12/17/2021,Washington,7170351,60,36208,611,167
12/18/2021,Washington,7170351,66,36274,615,173
12/19/2021,Washington,7170351,68,36342,600,165
12/20/2021,Washington,7170351,70,36412,625,173
12/21/2021,Washington,7170351,73,36485,624,176
12/22/2021,Washington,7170351,81,36566,637,170
12/23/2021,Washington,7170351,90,36656,642,162
12/24/2021,Washington,7170351,93,36749,666,164
12/25/2021,Washington,7170351,86,36835,680,171
12/26/2021,Washington,7170351,80,36915,701,168
12/27/2021,Washington,7170351,105,37020,743,171
12/28/2021,Washington,7170351,106,37126,802,169
12/29/2021,Washington,7170351,138,37264,836,192
12/30/2021,Washington,7170351,151,37415,887,198
12/31/2021,Washington,7170351,175,37590,945,205
1/1/2022,Washington,7170351,151,37741,999,219
1/2/2022,Washington,7170351,174,37915,1083,227
1/3/2022,Washington,7170351,200,38115,1229,246
1/4/2022,Washington,7170351,231,38346,1356,270
1/5/2022,Washington,7170351,187,38533,1451,277
1/6/2022,Washington,7170351,215,38748,1584,302
1/7/2022,Washington,7170351,222,38970,1662,299
1/8/2022,Washington,7170351,226,39196,1718,304
1/9/2022,Washington,7170351,205,39401,1759,304
1/10/2022,Washington,7170351,232,39633,1860,313
1/11/2022,Washington,7170351,265,39898,1942,337
1/12/2022,Washington,7170351,265,40163,2083,349
1/13/2022,Washington,7170351,281,40444,2138,345
1/14/2022,Washington,7170351,261,40705,2137,343
1/15/2022,Washington,7170351,261,40966,2203,362
1/16/2022,Washington,7170351,277,41243,2213,364
1/17/2022,Washington,7170351,264,41507,2223,374
1/18/2022,Washington,7170351,302,41809,2256,367
1/19/2022,Washington,7170351,300,42109,2324,367
1/20/2022,Washington,7170351,301,42410,2286,360
1/21/2022,Washington,7170351,296,42706,2288,374
1/22/2022,Washington,7170351,251,42957,2298,368
1/23/2022,Washington,7170351,212,43169,2284,381
1/24/2022,Washington,7170351,228,43397,2175,374
1/25/2022,Washington,7170351,240,43637,2155,377
1/26/2022,Washington,7170351,281,43918,2192,362
1/27/2022,Washington,7170351,254,44172,2137,339
1/28/2022,Washington,7170351,289,44461,2116,346
1/29/2022,Washington,7170351,227,44688,2060,342
1/30/2022,Washington,7170351,192,44880,2092,343
1/31/2022,Washington,7170351,221,45101,1959,337
2/1/2022,Washington,7170351,229,45330,1948,343
2/2/2022,Washington,7170351,200,45530,1926,351
2/3/2022,Washington,7170351,219,45749,1859,334
2/4/2022,Washington,7170351,203,45952,1816,309
2/5/2022,Washington,7170351,192,46144,1796,304
2/6/2022,Washington,7170351,155,46299,1769,306
2/7/2022,Washington,7170351,162,46461,1669,286
2/8/2022,Washington,7170351,182,46643,1641,279
2/9/2022,Washington,7170351,182,46825,1641,279
7/1/2021,Wisconsin,5771337,31,53224,97,31
7/2/2021,Wisconsin,5771337,11,53235,88,26
7/3/2021,Wisconsin,5771337,13,53248,75,25
7/4/2021,Wisconsin,5771337,11,53259,74,25
7/5/2021,Wisconsin,5771337,11,53270,78,23
7/6/2021,Wisconsin,5771337,16,53286,76,25
7/7/2021,Wisconsin,5771337,21,53307,78,27
7/8/2021,Wisconsin,5771337,19,53326,81,25
7/9/2021,Wisconsin,5771337,23,53349,79,27
7/10/2021,Wisconsin,5771337,25,53374,85,29
7/11/2021,Wisconsin,5771337,15,53389,81,29
7/12/2021,Wisconsin,5771337,28,53417,103,32
7/13/2021,Wisconsin,5771337,18,53435,105,31
7/14/2021,Wisconsin,5771337,26,53461,105,28
7/15/2021,Wisconsin,5771337,21,53482,100,32
7/16/2021,Wisconsin,5771337,30,53512,106,33
7/17/2021,Wisconsin,5771337,33,53545,104,29
7/18/2021,Wisconsin,5771337,35,53580,117,34
7/19/2021,Wisconsin,5771337,33,53613,138,37
7/20/2021,Wisconsin,5771337,26,53639,141,40
7/21/2021,Wisconsin,5771337,31,53670,155,37
7/22/2021,Wisconsin,5771337,39,53709,148,32
7/23/2021,Wisconsin,5771337,49,53758,151,40
7/24/2021,Wisconsin,5771337,49,53807,175,46
7/25/2021,Wisconsin,5771337,35,53842,181,54
7/26/2021,Wisconsin,5771337,36,53878,189,57
7/27/2021,Wisconsin,5771337,43,53921,185,60
7/28/2021,Wisconsin,5771337,45,53966,203,57
7/29/2021,Wisconsin,5771337,52,54018,229,58
7/30/2021,Wisconsin,5771337,69,54087,255,60
7/31/2021,Wisconsin,5771337,67,54154,268,66
8/1/2021,Wisconsin,5771337,50,54204,277,74
8/2/2021,Wisconsin,5771337,80,54284,324,92
8/3/2021,Wisconsin,5771337,86,54370,366,115
8/4/2021,Wisconsin,5771337,90,54460,377,118
8/5/2021,Wisconsin,5771337,98,54558,416,128
8/6/2021,Wisconsin,5771337,116,54674,457,127
8/7/2021,Wisconsin,5771337,93,54767,428,130
8/8/2021,Wisconsin,5771337,96,54863,456,141
8/9/2021,Wisconsin,5771337,114,54977,503,171
8/10/2021,Wisconsin,5771337,138,55115,541,160
8/11/2021,Wisconsin,5771337,153,55268,598,174
8/12/2021,Wisconsin,5771337,151,55419,635,193
8/13/2021,Wisconsin,5771337,150,55569,638,191
8/14/2021,Wisconsin,5771337,132,55701,621,185
8/15/2021,Wisconsin,5771337,150,55851,630,194
8/16/2021,Wisconsin,5771337,147,55998,699,222
8/17/2021,Wisconsin,5771337,178,56176,733,235
8/18/2021,Wisconsin,5771337,181,56357,790,251
8/19/2021,Wisconsin,5771337,169,56526,776,247
8/20/2021,Wisconsin,5771337,172,56698,782,241
8/21/2021,Wisconsin,5771337,170,56868,754,230
8/22/2021,Wisconsin,5771337,168,57036,775,236
8/23/2021,Wisconsin,5771337,178,57214,871,269
8/24/2021,Wisconsin,5771337,156,57370,881,271
8/25/2021,Wisconsin,5771337,148,57518,872,285
8/26/2021,Wisconsin,5771337,149,57667,819,259
8/27/2021,Wisconsin,5771337,157,57824,865,261
8/28/2021,Wisconsin,5771337,166,57990,855,255
8/29/2021,Wisconsin,5771337,167,58157,902,273
8/30/2021,Wisconsin,5771337,169,58326,969,294
8/31/2021,Wisconsin,5771337,230,58556,1000,288
9/1/2021,Wisconsin,5771337,204,58760,1010,289
9/2/2021,Wisconsin,5771337,207,58967,1022,294
9/3/2021,Wisconsin,5771337,202,59169,1006,305
9/4/2021,Wisconsin,5771337,205,59374,992,305
9/5/2021,Wisconsin,5771337,201,59575,1021,296
9/6/2021,Wisconsin,5771337,171,59746,1011,305
9/7/2021,Wisconsin,5771337,229,59975,1119,332
9/8/2021,Wisconsin,5771337,204,60179,1104,332
9/9/2021,Wisconsin,5771337,234,60413,1136,326
9/10/2021,Wisconsin,5771337,217,60630,1062,313
9/11/2021,Wisconsin,5771337,225,60855,1070,314
9/12/2021,Wisconsin,5771337,200,61055,1049,326
9/13/2021,Wisconsin,5771337,199,61254,1076,328
9/14/2021,Wisconsin,5771337,228,61482,1072,313
9/15/2021,Wisconsin,5771337,206,61688,1092,321
9/16/2021,Wisconsin,5771337,218,61906,1108,323
9/17/2021,Wisconsin,5771337,211,62117,1136,337
9/18/2021,Wisconsin,5771337,252,62369,1119,324
9/19/2021,Wisconsin,5771337,193,62562,1141,329
9/20/2021,Wisconsin,5771337,204,62766,1139,329
9/21/2021,Wisconsin,5771337,240,63006,1126,330
9/22/2021,Wisconsin,5771337,240,63246,1189,339
9/23/2021,Wisconsin,5771337,241,63487,1196,355
9/24/2021,Wisconsin,5771337,215,63702,1158,355
9/25/2021,Wisconsin,5771337,218,63920,1126,336
9/26/2021,Wisconsin,5771337,206,64126,1147,336
9/27/2021,Wisconsin,5771337,188,64314,1196,356
9/28/2021,Wisconsin,5771337,222,64536,1181,336
9/29/2021,Wisconsin,5771337,205,64741,1183,347
9/30/2021,Wisconsin,5771337,211,64952,1194,348
10/1/2021,Wisconsin,5771337,206,65158,1194,347
10/2/2021,Wisconsin,5771337,190,65348,1164,333
10/3/2021,Wisconsin,5771337,193,65541,1168,329
10/4/2021,Wisconsin,5771337,195,65736,1263,343
10/5/2021,Wisconsin,5771337,214,65950,1225,338
10/6/2021,Wisconsin,5771337,193,66143,1213,332
10/7/2021,Wisconsin,5771337,223,66366,1215,325
10/8/2021,Wisconsin,5771337,223,66589,1228,316
10/9/2021,Wisconsin,5771337,204,66793,1192,311
10/10/2021,Wisconsin,5771337,203,66996,1213,317
10/11/2021,Wisconsin,5771337,191,67187,1269,335
10/12/2021,Wisconsin,5771337,214,67401,1259,342
10/13/2021,Wisconsin,5771337,190,67591,1232,327
10/14/2021,Wisconsin,5771337,194,67785,1199,312
10/15/2021,Wisconsin,5771337,180,67965,1169,323
10/16/2021,Wisconsin,5771337,187,68152,1117,310
10/17/2021,Wisconsin,5771337,184,68336,1104,308
10/18/2021,Wisconsin,5771337,155,68491,1126,329
10/19/2021,Wisconsin,5771337,197,68688,1148,327
10/20/2021,Wisconsin,5771337,178,68866,1137,332
10/21/2021,Wisconsin,5771337,164,69030,1076,325
10/22/2021,Wisconsin,5771337,158,69188,1055,334
10/23/2021,Wisconsin,5771337,162,69350,1006,308
10/24/2021,Wisconsin,5771337,131,69481,978,295
10/25/2021,Wisconsin,5771337,139,69620,997,304
10/26/2021,Wisconsin,5771337,140,69760,977,313
10/27/2021,Wisconsin,5771337,152,69912,955,300
10/28/2021,Wisconsin,5771337,146,70058,952,310
10/29/2021,Wisconsin,5771337,134,70192,944,299
10/30/2021,Wisconsin,5771337,149,70341,935,289
10/31/2021,Wisconsin,5771337,150,70491,958,279
11/1/2021,Wisconsin,5771337,120,70611,948,282
11/2/2021,Wisconsin,5771337,172,70783,984,287
11/3/2021,Wisconsin,5771337,172,70955,995,280
11/4/2021,Wisconsin,5771337,172,71127,989,277
11/5/2021,Wisconsin,5771337,183,71310,1007,262
11/6/2021,Wisconsin,5771337,170,71480,985,261
11/7/2021,Wisconsin,5771337,158,71638,1021,263
11/8/2021,Wisconsin,5771337,163,71801,1081,295
11/9/2021,Wisconsin,5771337,209,72010,1124,305
11/10/2021,Wisconsin,5771337,188,72198,1158,295
11/11/2021,Wisconsin,5771337,194,72392,1139,291
11/12/2021,Wisconsin,5771337,215,72607,1153,296
11/13/2021,Wisconsin,5771337,199,72806,1142,293
11/14/2021,Wisconsin,5771337,193,72999,1168,300
11/15/2021,Wisconsin,5771337,183,73182,1211,311
11/16/2021,Wisconsin,5771337,241,73423,1264,330
11/17/2021,Wisconsin,5771337,223,73646,1296,337
11/18/2021,Wisconsin,5771337,249,73895,1337,340
11/19/2021,Wisconsin,5771337,237,74132,1355,344
11/20/2021,Wisconsin,5771337,202,74334,1275,322
11/21/2021,Wisconsin,5771337,218,74552,1274,319
11/22/2021,Wisconsin,5771337,223,74775,1342,358
11/23/2021,Wisconsin,5771337,265,75040,1382,349
11/24/2021,Wisconsin,5771337,242,75282,1421,369
11/25/2021,Wisconsin,5771337,258,75540,1383,351
11/26/2021,Wisconsin,5771337,212,75752,1411,361
11/27/2021,Wisconsin,5771337,255,76007,1427,364
11/28/2021,Wisconsin,5771337,210,76217,1478,386
11/29/2021,Wisconsin,5771337,243,76460,1553,410
11/30/2021,Wisconsin,5771337,266,76726,1539,423
12/1/2021,Wisconsin,5771337,265,76991,1538,431
12/2/2021,Wisconsin,5771337,268,77259,1575,441
12/3/2021,Wisconsin,5771337,265,77524,1586,430
12/4/2021,Wisconsin,5771337,305,77829,1586,425
12/5/2021,Wisconsin,5771337,279,78108,1612,428
12/6/2021,Wisconsin,5771337,283,78391,1719,446
12/7/2021,Wisconsin,5771337,338,78729,1780,463
12/8/2021,Wisconsin,5771337,289,79018,1759,470
12/9/2021,Wisconsin,5771337,319,79337,1768,472
12/10/2021,Wisconsin,5771337,316,79653,1797,481
12/11/2021,Wisconsin,5771337,321,79974,1790,456
12/12/2021,Wisconsin,5771337,264,80238,1778,454
12/13/2021,Wisconsin,5771337,267,80505,1868,483
12/14/2021,Wisconsin,5771337,323,80828,1834,471
12/15/2021,Wisconsin,5771337,289,81117,1795,467
12/16/2021,Wisconsin,5771337,314,81431,1814,458
12/17/2021,Wisconsin,5771337,291,81722,1774,446
12/18/2021,Wisconsin,5771337,279,82001,1694,428
12/19/2021,Wisconsin,5771337,279,82280,1728,437
12/20/2021,Wisconsin,5771337,281,82561,1807,466
12/21/2021,Wisconsin,5771337,297,82858,1781,463
12/22/2021,Wisconsin,5771337,232,83090,1756,448
12/23/2021,Wisconsin,5771337,243,83333,1725,442
12/24/2021,Wisconsin,5771337,245,83578,1691,442
12/25/2021,Wisconsin,5771337,264,83842,1646,423
12/26/2021,Wisconsin,5771337,201,84043,1670,441
12/27/2021,Wisconsin,5771337,267,84310,1746,462
12/28/2021,Wisconsin,5771337,304,84614,1818,456
12/29/2021,Wisconsin,5771337,277,84891,1849,464
12/30/2021,Wisconsin,5771337,285,85176,1852,453
12/31/2021,Wisconsin,5771337,313,85489,1800,437
1/1/2022,Wisconsin,5771337,292,85781,1870,461
1/2/2022,Wisconsin,5771337,303,86084,1933,462
1/3/2022,Wisconsin,5771337,295,86379,2064,520
1/4/2022,Wisconsin,5771337,364,86743,2125,512
1/5/2022,Wisconsin,5771337,374,87117,2166,505
1/6/2022,Wisconsin,5771337,387,87504,2251,519
1/7/2022,Wisconsin,5771337,377,87881,2299,521
1/8/2022,Wisconsin,5771337,391,88272,2306,511
1/9/2022,Wisconsin,5771337,368,88640,2384,529
1/10/2022,Wisconsin,5771337,335,88975,2437,522
1/11/2022,Wisconsin,5771337,407,89382,2429,531
1/12/2022,Wisconsin,5771337,443,89825,2486,536
1/13/2022,Wisconsin,5771337,380,90205,2417,524
1/14/2022,Wisconsin,5771337,387,90592,2462,525
1/15/2022,Wisconsin,5771337,398,90990,2404,521
1/16/2022,Wisconsin,5771337,327,91317,2424,516
1/17/2022,Wisconsin,5771337,331,91648,2416,483
1/18/2022,Wisconsin,5771337,412,92060,2380,501
1/19/2022,Wisconsin,5771337,356,92416,2350,490
1/20/2022,Wisconsin,5771337,341,92757,2295,481
1/21/2022,Wisconsin,5771337,310,93067,2209,455
1/22/2022,Wisconsin,5771337,298,93365,2122,451
1/23/2022,Wisconsin,5771337,277,93642,2107,436
1/24/2022,Wisconsin,5771337,251,93893,2066,429
1/25/2022,Wisconsin,5771337,321,94214,2025,426
1/26/2022,Wisconsin,5771337,271,94485,2017,397
1/27/2022,Wisconsin,5771337,295,94780,1972,387
1/28/2022,Wisconsin,5771337,291,95071,1889,388
1/29/2022,Wisconsin,5771337,274,95345,1792,374
1/30/2022,Wisconsin,5771337,190,95535,1762,334
1/31/2022,Wisconsin,5771337,206,95741,1730,341
2/1/2022,Wisconsin,5771337,251,95992,1640,336
2/2/2022,Wisconsin,5771337,227,96219,1590,322
2/3/2022,Wisconsin,5771337,211,96430,1519,299
2/4/2022,Wisconsin,5771337,219,96649,1477,301
2/5/2022,Wisconsin,5771337,245,96894,1349,290
2/6/2022,Wisconsin,5771337,167,97061,1319,272
2/7/2022,Wisconsin,5771337,138,97199,1343,257
2/8/2022,Wisconsin,5771337,185,97384,1300,237
2/9/2022,Wisconsin,5771337,185,97569,1300,237
7/1/2021,West Virginia,1844128,7,12286,73,25
7/2/2021,West Virginia,1844128,7,12293,71,25
7/3/2021,West Virginia,1844128,4,12297,64,19
7/4/2021,West Virginia,1844128,2,12299,58,18
7/5/2021,West Virginia,1844128,9,12308,61,20
7/6/2021,West Virginia,1844128,10,12318,64,22
7/7/2021,West Virginia,1844128,15,12333,80,24
7/8/2021,West Virginia,1844128,7,12340,82,25
7/9/2021,West Virginia,1844128,9,12349,87,35
7/10/2021,West Virginia,1844128,11,12360,90,38
7/11/2021,West Virginia,1844128,5,12365,85,37
7/12/2021,West Virginia,1844128,7,12372,85,43
7/13/2021,West Virginia,1844128,9,12381,89,39
7/14/2021,West Virginia,1844128,9,12390,85,34
7/15/2021,West Virginia,1844128,12,12402,85,35
7/16/2021,West Virginia,1844128,8,12410,77,33
7/17/2021,West Virginia,1844128,9,12419,75,30
7/18/2021,West Virginia,1844128,10,12429,82,32
7/19/2021,West Virginia,1844128,10,12439,88,36
7/20/2021,West Virginia,1844128,14,12453,92,40
7/21/2021,West Virginia,1844128,14,12467,98,40
7/22/2021,West Virginia,1844128,5,12472,99,37
7/23/2021,West Virginia,1844128,12,12484,104,41
7/24/2021,West Virginia,1844128,16,12500,110,44
7/25/2021,West Virginia,1844128,16,12516,114,45
7/26/2021,West Virginia,1844128,21,12537,123,49
7/27/2021,West Virginia,1844128,22,12559,136,54
7/28/2021,West Virginia,1844128,24,12583,142,55
7/29/2021,West Virginia,1844128,23,12606,157,59
7/30/2021,West Virginia,1844128,21,12627,164,67
7/31/2021,West Virginia,1844128,20,12647,167,68
8/1/2021,West Virginia,1844128,22,12669,170,67
8/2/2021,West Virginia,1844128,33,12702,188,63
8/3/2021,West Virginia,1844128,22,12724,197,70
8/4/2021,West Virginia,1844128,41,12765,216,68
8/5/2021,West Virginia,1844128,38,12803,224,69
8/6/2021,West Virginia,1844128,36,12839,231,72
8/7/2021,West Virginia,1844128,43,12882,252,76
8/8/2021,West Virginia,1844128,43,12925,270,85
8/9/2021,West Virginia,1844128,31,12956,283,101
8/10/2021,West Virginia,1844128,39,12995,288,112
8/11/2021,West Virginia,1844128,46,13041,303,105
8/12/2021,West Virginia,1844128,46,13087,327,109
8/13/2021,West Virginia,1844128,44,13131,336,111
8/14/2021,West Virginia,1844128,53,13184,349,116
8/15/2021,West Virginia,1844128,62,13246,362,119
8/16/2021,West Virginia,1844128,57,13303,385,129
8/17/2021,West Virginia,1844128,70,13373,428,136
8/18/2021,West Virginia,1844128,66,13439,448,134
8/19/2021,West Virginia,1844128,57,13496,451,134
8/20/2021,West Virginia,1844128,61,13557,474,146
8/21/2021,West Virginia,1844128,63,13620,496,161
8/22/2021,West Virginia,1844128,62,13682,502,173
8/23/2021,West Virginia,1844128,67,13749,519,169
8/24/2021,West Virginia,1844128,75,13824,546,174
8/25/2021,West Virginia,1844128,64,13888,553,184
8/26/2021,West Virginia,1844128,81,13969,586,184
8/27/2021,West Virginia,1844128,108,14077,602,187
8/28/2021,West Virginia,1844128,101,14178,638,200
8/29/2021,West Virginia,1844128,84,14262,643,198
8/30/2021,West Virginia,1844128,85,14347,669,213
8/31/2021,West Virginia,1844128,92,14439,681,210
9/1/2021,West Virginia,1844128,98,14537,709,210
9/2/2021,West Virginia,1844128,111,14648,749,212
9/3/2021,West Virginia,1844128,93,14741,752,222
9/4/2021,West Virginia,1844128,103,14844,758,232
9/5/2021,West Virginia,1844128,86,14930,776,244
9/6/2021,West Virginia,1844128,79,15009,785,250
9/7/2021,West Virginia,1844128,97,15106,814,254
9/8/2021,West Virginia,1844128,104,15210,864,255
9/9/2021,West Virginia,1844128,94,15304,852,257
9/10/2021,West Virginia,1844128,90,15394,853,256
9/11/2021,West Virginia,1844128,101,15495,845,255
9/12/2021,West Virginia,1844128,99,15594,878,264
9/13/2021,West Virginia,1844128,93,15687,896,270
9/14/2021,West Virginia,1844128,109,15796,920,271
9/15/2021,West Virginia,1844128,123,15919,942,280
9/16/2021,West Virginia,1844128,103,16022,949,291
9/17/2021,West Virginia,1844128,107,16129,969,286
9/18/2021,West Virginia,1844128,121,16250,986,299
9/19/2021,West Virginia,1844128,103,16353,1006,293
9/20/2021,West Virginia,1844128,74,16427,994,300
9/21/2021,West Virginia,1844128,109,16536,1019,290
9/22/2021,West Virginia,1844128,158,16694,1048,292
9/23/2021,West Virginia,1844128,112,16806,1065,301
9/24/2021,West Virginia,1844128,110,16916,1074,302
9/25/2021,West Virginia,1844128,92,17008,1044,300
9/26/2021,West Virginia,1844128,91,17099,1043,300
9/27/2021,West Virginia,1844128,76,17175,1050,305
9/28/2021,West Virginia,1844128,110,17285,1074,311
9/29/2021,West Virginia,1844128,93,17378,1064,307
9/30/2021,West Virginia,1844128,120,17498,1062,291
10/1/2021,West Virginia,1844128,110,17608,1038,275
10/2/2021,West Virginia,1844128,91,17699,1019,277
10/3/2021,West Virginia,1844128,82,17781,995,280
10/4/2021,West Virginia,1844128,68,17849,1008,281
10/5/2021,West Virginia,1844128,90,17939,986,268
10/6/2021,West Virginia,1844128,95,18034,964,256
10/7/2021,West Virginia,1844128,93,18127,940,248
10/8/2021,West Virginia,1844128,102,18229,907,232
10/9/2021,West Virginia,1844128,95,18324,910,239
10/10/2021,West Virginia,1844128,69,18393,883,244
10/11/2021,West Virginia,1844128,72,18465,881,239
10/12/2021,West Virginia,1844128,79,18544,909,237
10/13/2021,West Virginia,1844128,89,18633,889,237
10/14/2021,West Virginia,1844128,97,18730,874,228
10/15/2021,West Virginia,1844128,72,18802,836,221
10/16/2021,West Virginia,1844128,75,18877,826,220
10/17/2021,West Virginia,1844128,49,18926,791,212
10/18/2021,West Virginia,1844128,56,18982,798,214
10/19/2021,West Virginia,1844128,81,19063,776,203
10/20/2021,West Virginia,1844128,71,19134,755,207
10/21/2021,West Virginia,1844128,77,19211,748,197
10/22/2021,West Virginia,1844128,55,19266,740,196
10/23/2021,West Virginia,1844128,66,19332,716,193
10/24/2021,West Virginia,1844128,62,19394,698,185
10/25/2021,West Virginia,1844128,51,19445,690,183
10/26/2021,West Virginia,1844128,62,19507,674,194
10/27/2021,West Virginia,1844128,61,19568,645,186
10/28/2021,West Virginia,1844128,68,19636,649,183
10/29/2021,West Virginia,1844128,72,19708,637,176
10/30/2021,West Virginia,1844128,57,19765,625,191
10/31/2021,West Virginia,1844128,41,19806,601,168
11/1/2021,West Virginia,1844128,47,19853,620,178
11/2/2021,West Virginia,1844128,60,19913,611,179
11/3/2021,West Virginia,1844128,60,19973,590,171
11/4/2021,West Virginia,1844128,48,20021,557,170
11/5/2021,West Virginia,1844128,66,20087,559,179
11/6/2021,West Virginia,1844128,50,20137,524,165
11/7/2021,West Virginia,1844128,49,20186,537,171
11/8/2021,West Virginia,1844128,43,20229,540,171
11/9/2021,West Virginia,1844128,60,20289,548,165
11/10/2021,West Virginia,1844128,48,20337,531,154
11/11/2021,West Virginia,1844128,60,20397,526,157
11/12/2021,West Virginia,1844128,55,20452,527,147
11/13/2021,West Virginia,1844128,60,20512,507,146
11/14/2021,West Virginia,1844128,44,20556,521,139
11/15/2021,West Virginia,1844128,51,20607,530,145
11/16/2021,West Virginia,1844128,60,20667,521,143
11/17/2021,West Virginia,1844128,60,20727,521,144
11/18/2021,West Virginia,1844128,61,20788,524,141
11/19/2021,West Virginia,1844128,53,20841,520,148
11/20/2021,West Virginia,1844128,58,20899,509,144
11/21/2021,West Virginia,1844128,56,20955,524,149
11/22/2021,West Virginia,1844128,61,21016,549,156
11/23/2021,West Virginia,1844128,50,21066,536,153
11/24/2021,West Virginia,1844128,54,21120,545,186
11/25/2021,West Virginia,1844128,50,21170,532,183
11/26/2021,West Virginia,1844128,52,21222,543,175
11/27/2021,West Virginia,1844128,63,21285,567,185
11/28/2021,West Virginia,1844128,55,21340,572,192
11/29/2021,West Virginia,1844128,58,21398,595,188
11/30/2021,West Virginia,1844128,55,21453,565,163
12/1/2021,West Virginia,1844128,59,21512,581,172
12/2/2021,West Virginia,1844128,73,21585,574,175
12/3/2021,West Virginia,1844128,68,21653,588,174
12/4/2021,West Virginia,1844128,65,21718,580,173
12/5/2021,West Virginia,1844128,41,21759,551,181
12/6/2021,West Virginia,1844128,71,21830,587,179
12/7/2021,West Virginia,1844128,88,21918,585,182
12/8/2021,West Virginia,1844128,80,21998,595,185
12/9/2021,West Virginia,1844128,84,22082,612,191
12/10/2021,West Virginia,1844128,85,22167,616,191
12/11/2021,West Virginia,1844128,79,22246,605,186
12/12/2021,West Virginia,1844128,68,22314,617,185
12/13/2021,West Virginia,1844128,59,22373,648,184
12/14/2021,West Virginia,1844128,76,22449,658,193
12/15/2021,West Virginia,1844128,61,22510,648,184
12/16/2021,West Virginia,1844128,58,22568,640,180
12/17/2021,West Virginia,1844128,59,22627,646,186
12/18/2021,West Virginia,1844128,69,22696,634,194
12/19/2021,West Virginia,1844128,46,22742,623,187
12/20/2021,West Virginia,1844128,59,22801,633,194
12/21/2021,West Virginia,1844128,76,22877,619,191
12/22/2021,West Virginia,1844128,54,22931,612,215
12/23/2021,West Virginia,1844128,70,23001,593,186
12/24/2021,West Virginia,1844128,70,23071,582,182
12/25/2021,West Virginia,1844128,61,23132,563,176
12/26/2021,West Virginia,1844128,60,23192,581,178
12/27/2021,West Virginia,1844128,79,23271,627,172
12/28/2021,West Virginia,1844128,98,23369,674,198
12/29/2021,West Virginia,1844128,98,23467,649,173
12/30/2021,West Virginia,1844128,85,23552,661,183
12/31/2021,West Virginia,1844128,84,23636,686,181
1/1/2022,West Virginia,1844128,90,23726,683,181
1/2/2022,West Virginia,1844128,84,23810,699,172
1/3/2022,West Virginia,1844128,82,23892,744,173
1/4/2022,West Virginia,1844128,81,23973,740,177
1/5/2022,West Virginia,1844128,109,24082,790,192
1/6/2022,West Virginia,1844128,115,24197,789,181
1/7/2022,West Virginia,1844128,96,24293,801,184
1/8/2022,West Virginia,1844128,97,24390,797,187
1/9/2022,West Virginia,1844128,111,24501,810,190
1/10/2022,West Virginia,1844128,108,24609,854,204
1/11/2022,West Virginia,1844128,99,24708,848,201
1/12/2022,West Virginia,1844128,123,24831,898,200
1/13/2022,West Virginia,1844128,111,24942,921,198
1/14/2022,West Virginia,1844128,104,25046,914,192
1/15/2022,West Virginia,1844128,128,25174,905,190
1/16/2022,West Virginia,1844128,101,25275,902,189
1/17/2022,West Virginia,1844128,96,25371,931,193
1/18/2022,West Virginia,1844128,122,25493,993,199
1/19/2022,West Virginia,1844128,129,25622,1022,211
1/20/2022,West Virginia,1844128,152,25774,1045,206
1/21/2022,West Virginia,1844128,138,25912,1095,219
1/22/2022,West Virginia,1844128,129,26041,1104,203
1/23/2022,West Virginia,1844128,132,26173,1085,198
1/24/2022,West Virginia,1844128,109,26282,1100,211
1/25/2022,West Virginia,1844128,144,26426,1140,206
1/26/2022,West Virginia,1844128,169,26595,1203,223
1/27/2022,West Virginia,1844128,161,26756,1233,206
1/28/2022,West Virginia,1844128,149,26905,1218,215
1/29/2022,West Virginia,1844128,124,27029,1195,218
1/30/2022,West Virginia,1844128,122,27151,1203,221
1/31/2022,West Virginia,1844128,113,27264,1215,224
2/1/2022,West Virginia,1844128,122,27386,1245,228
2/2/2022,West Virginia,1844128,145,27531,1228,226
2/3/2022,West Virginia,1844128,140,27671,1203,223
2/4/2022,West Virginia,1844128,124,27795,1186,238
2/5/2022,West Virginia,1844128,94,27889,1136,200
2/6/2022,West Virginia,1844128,96,27985,1102,197
2/7/2022,West Virginia,1844128,102,28087,1103,199
2/8/2022,West Virginia,1844128,117,28204,1046,203
2/9/2022,West Virginia,1844128,117,28321,1046,203
7/1/2021,Wyoming,586107,8,4289,40,7
7/2/2021,Wyoming,586107,3,4292,41,9
7/3/2021,Wyoming,586107,12,4304,48,13
7/4/2021,Wyoming,586107,6,4310,45,15
7/5/2021,Wyoming,586107,7,4317,44,13
7/6/2021,Wyoming,586107,7,4324,50,16
7/7/2021,Wyoming,586107,12,4336,53,17
7/8/2021,Wyoming,586107,8,4344,53,17
7/9/2021,Wyoming,586107,5,4349,49,17
7/10/2021,Wyoming,586107,10,4359,50,17
7/11/2021,Wyoming,586107,9,4368,48,18
7/12/2021,Wyoming,586107,8,4376,48,17
7/13/2021,Wyoming,586107,9,4385,51,16
7/14/2021,Wyoming,586107,13,4398,57,20
7/15/2021,Wyoming,586107,12,4410,63,22
7/16/2021,Wyoming,586107,13,4423,63,23
7/17/2021,Wyoming,586107,14,4437,64,23
7/18/2021,Wyoming,586107,11,4448,55,23
7/19/2021,Wyoming,586107,18,4466,61,24
7/20/2021,Wyoming,586107,23,4489,67,20
7/21/2021,Wyoming,586107,13,4502,63,18
7/22/2021,Wyoming,586107,18,4520,66,16
7/23/2021,Wyoming,586107,19,4539,75,18
7/24/2021,Wyoming,586107,14,4553,72,23
7/25/2021,Wyoming,586107,12,4565,70,21
7/26/2021,Wyoming,586107,11,4576,74,21
7/27/2021,Wyoming,586107,13,4589,72,20
7/28/2021,Wyoming,586107,13,4602,69,22
7/29/2021,Wyoming,586107,9,4611,62,23
7/30/2021,Wyoming,586107,9,4620,63,22
7/31/2021,Wyoming,586107,20,4640,59,17
8/1/2021,Wyoming,586107,22,4662,62,18
8/2/2021,Wyoming,586107,17,4679,71,24
8/3/2021,Wyoming,586107,14,4693,84,25
8/4/2021,Wyoming,586107,12,4705,81,23
8/5/2021,Wyoming,586107,11,4716,76,17
8/6/2021,Wyoming,586107,17,4733,76,16
8/7/2021,Wyoming,586107,25,4758,83,17
8/8/2021,Wyoming,586107,14,4772,89,18
8/9/2021,Wyoming,586107,19,4791,95,15
8/10/2021,Wyoming,586107,19,4810,100,22
8/11/2021,Wyoming,586107,25,4835,97,24
8/12/2021,Wyoming,586107,15,4850,99,24
8/13/2021,Wyoming,586107,23,4873,99,25
8/14/2021,Wyoming,586107,28,4901,106,26
8/15/2021,Wyoming,586107,24,4925,108,24
8/16/2021,Wyoming,586107,13,4938,109,23
8/17/2021,Wyoming,586107,28,4966,120,23
8/18/2021,Wyoming,586107,28,4994,121,25
8/19/2021,Wyoming,586107,43,5037,134,30
8/20/2021,Wyoming,586107,28,5065,144,31
8/21/2021,Wyoming,586107,33,5098,139,29
8/22/2021,Wyoming,586107,24,5122,139,30
8/23/2021,Wyoming,586107,46,5168,171,35
8/24/2021,Wyoming,586107,46,5214,169,35
8/25/2021,Wyoming,586107,46,5260,177,41
8/26/2021,Wyoming,586107,43,5303,179,41
8/27/2021,Wyoming,586107,38,5341,182,41
8/28/2021,Wyoming,586107,38,5379,183,47
8/29/2021,Wyoming,586107,45,5424,193,50
8/30/2021,Wyoming,586107,29,5453,201,59
8/31/2021,Wyoming,586107,28,5481,199,56
9/1/2021,Wyoming,586107,35,5516,202,58
9/2/2021,Wyoming,586107,27,5543,202,55
9/3/2021,Wyoming,586107,29,5572,188,58
9/4/2021,Wyoming,586107,36,5608,195,62
9/5/2021,Wyoming,586107,32,5640,200,58
9/6/2021,Wyoming,586107,30,5670,203,54
9/7/2021,Wyoming,586107,40,5710,229,54
9/8/2021,Wyoming,586107,44,5754,232,45
9/9/2021,Wyoming,586107,36,5790,215,50
9/10/2021,Wyoming,586107,25,5815,212,47
9/11/2021,Wyoming,586107,31,5846,208,47
9/12/2021,Wyoming,586107,33,5879,221,53
9/13/2021,Wyoming,586107,28,5907,218,51
9/14/2021,Wyoming,586107,32,5939,213,52
9/15/2021,Wyoming,586107,37,5976,212,54
9/16/2021,Wyoming,586107,31,6007,200,51
9/17/2021,Wyoming,586107,33,6040,198,55
9/18/2021,Wyoming,586107,26,6066,173,52
9/19/2021,Wyoming,586107,27,6093,183,61
9/20/2021,Wyoming,586107,35,6128,208,62
9/21/2021,Wyoming,586107,33,6161,198,59
9/22/2021,Wyoming,586107,33,6194,209,58
9/23/2021,Wyoming,586107,33,6227,218,59
9/24/2021,Wyoming,586107,29,6256,216,58
9/25/2021,Wyoming,586107,22,6278,216,62
9/26/2021,Wyoming,586107,23,6301,202,63
9/27/2021,Wyoming,586107,29,6330,208,60
9/28/2021,Wyoming,586107,32,6362,229,61
9/29/2021,Wyoming,586107,30,6392,224,69
9/30/2021,Wyoming,586107,32,6424,228,67
10/1/2021,Wyoming,586107,27,6451,217,72
10/2/2021,Wyoming,586107,23,6474,211,68
10/3/2021,Wyoming,586107,30,6504,212,63
10/4/2021,Wyoming,586107,23,6527,203,61
10/5/2021,Wyoming,586107,33,6560,204,63
10/6/2021,Wyoming,586107,34,6594,207,65
10/7/2021,Wyoming,586107,44,6638,220,56
10/8/2021,Wyoming,586107,35,6673,216,59
10/9/2021,Wyoming,586107,44,6717,205,58
10/10/2021,Wyoming,586107,36,6753,225,64
10/11/2021,Wyoming,586107,51,6804,225,63
10/12/2021,Wyoming,586107,48,6852,222,62
10/13/2021,Wyoming,586107,38,6890,224,59
10/14/2021,Wyoming,586107,32,6922,221,60
10/15/2021,Wyoming,586107,36,6958,215,58
10/16/2021,Wyoming,586107,39,6997,209,63
10/17/2021,Wyoming,586107,31,7028,208,59
10/18/2021,Wyoming,586107,30,7058,220,63
10/19/2021,Wyoming,586107,46,7104,243,64
10/20/2021,Wyoming,586107,31,7135,234,60
10/21/2021,Wyoming,586107,39,7174,247,66
10/22/2021,Wyoming,586107,34,7208,246,70
10/23/2021,Wyoming,586107,33,7241,232,64
10/24/2021,Wyoming,586107,34,7275,232,70
10/25/2021,Wyoming,586107,38,7313,239,69
10/26/2021,Wyoming,586107,35,7348,238,67
10/27/2021,Wyoming,586107,37,7385,228,62
10/28/2021,Wyoming,586107,27,7412,212,57
10/29/2021,Wyoming,586107,31,7443,194,52
10/30/2021,Wyoming,586107,32,7475,183,47
10/31/2021,Wyoming,586107,21,7496,176,43
11/1/2021,Wyoming,586107,26,7522,181,45
11/2/2021,Wyoming,586107,28,7550,179,43
11/3/2021,Wyoming,586107,35,7585,179,41
11/4/2021,Wyoming,586107,28,7613,175,36
11/5/2021,Wyoming,586107,26,7639,171,36
11/6/2021,Wyoming,586107,33,7672,167,37
11/7/2021,Wyoming,586107,25,7697,169,41
11/8/2021,Wyoming,586107,27,7724,175,41
11/9/2021,Wyoming,586107,27,7751,167,39
11/10/2021,Wyoming,586107,18,7769,164,34
11/11/2021,Wyoming,586107,19,7788,163,37
11/12/2021,Wyoming,586107,23,7811,171,37
11/13/2021,Wyoming,586107,20,7831,164,36
11/14/2021,Wyoming,586107,26,7857,161,35
11/15/2021,Wyoming,586107,18,7875,163,36
11/16/2021,Wyoming,586107,25,7900,158,36
11/17/2021,Wyoming,586107,14,7914,152,31
11/18/2021,Wyoming,586107,21,7935,151,30
11/19/2021,Wyoming,586107,29,7964,148,32
11/20/2021,Wyoming,586107,26,7990,144,31
11/21/2021,Wyoming,586107,21,8011,139,35
11/22/2021,Wyoming,586107,16,8027,135,34
11/23/2021,Wyoming,586107,14,8041,125,27
11/24/2021,Wyoming,586107,21,8062,120,26
11/25/2021,Wyoming,586107,23,8085,122,26
11/26/2021,Wyoming,586107,12,8097,125,26
11/27/2021,Wyoming,586107,15,8112,126,23
11/28/2021,Wyoming,586107,8,8120,122,21
11/29/2021,Wyoming,586107,21,8141,121,20
11/30/2021,Wyoming,586107,18,8159,116,18
12/1/2021,Wyoming,586107,19,8178,115,22
12/2/2021,Wyoming,586107,13,8191,108,26
12/3/2021,Wyoming,586107,17,8208,115,29
12/4/2021,Wyoming,586107,11,8219,111,32
12/5/2021,Wyoming,586107,17,8236,114,29
12/6/2021,Wyoming,586107,15,8251,114,30
12/7/2021,Wyoming,586107,17,8268,114,29
12/8/2021,Wyoming,586107,16,8284,111,26
12/9/2021,Wyoming,586107,19,8303,109,27
12/10/2021,Wyoming,586107,17,8320,115,31
12/11/2021,Wyoming,586107,9,8329,108,30
12/12/2021,Wyoming,586107,14,8343,104,34
12/13/2021,Wyoming,586107,10,8353,106,31
12/14/2021,Wyoming,586107,15,8368,107,34
12/15/2021,Wyoming,586107,17,8385,106,33
12/16/2021,Wyoming,586107,4,8389,99,32
12/17/2021,Wyoming,586107,18,8407,104,32
12/18/2021,Wyoming,586107,11,8418,95,26
12/19/2021,Wyoming,586107,11,8429,96,24
12/20/2021,Wyoming,586107,13,8442,81,20
12/21/2021,Wyoming,586107,14,8456,80,20
12/22/2021,Wyoming,586107,10,8466,78,25
12/23/2021,Wyoming,586107,12,8478,76,26
12/24/2021,Wyoming,586107,9,8487,69,26
12/25/2021,Wyoming,586107,10,8497,70,28
12/26/2021,Wyoming,586107,8,8505,63,27
12/27/2021,Wyoming,586107,6,8511,64,25
12/28/2021,Wyoming,586107,12,8523,69,21
12/29/2021,Wyoming,586107,8,8531,74,25
12/30/2021,Wyoming,586107,11,8542,67,24
12/31/2021,Wyoming,586107,12,8554,68,25
1/1/2022,Wyoming,586107,7,8561,56,20
1/2/2022,Wyoming,586107,13,8574,55,21
1/3/2022,Wyoming,586107,11,8585,65,20
1/4/2022,Wyoming,586107,16,8601,64,17
1/5/2022,Wyoming,586107,11,8612,64,17
1/6/2022,Wyoming,586107,16,8628,72,19
1/7/2022,Wyoming,586107,11,8639,72,19
1/8/2022,Wyoming,586107,12,8651,73,17
1/9/2022,Wyoming,586107,13,8664,72,17
1/10/2022,Wyoming,586107,10,8674,67,17
1/11/2022,Wyoming,586107,18,8692,68,20
1/12/2022,Wyoming,586107,13,8705,78,16
1/13/2022,Wyoming,586107,25,8730,93,22
1/14/2022,Wyoming,586107,30,8760,108,25
1/15/2022,Wyoming,586107,27,8787,111,27
1/16/2022,Wyoming,586107,20,8807,109,22
1/17/2022,Wyoming,586107,19,8826,104,17
1/18/2022,Wyoming,586107,23,8849,106,12
1/19/2022,Wyoming,586107,20,8869,118,18
1/20/2022,Wyoming,586107,26,8895,114,19
1/21/2022,Wyoming,586107,38,8933,133,19
1/22/2022,Wyoming,586107,27,8960,126,17
1/23/2022,Wyoming,586107,15,8975,121,17
1/24/2022,Wyoming,586107,29,9004,135,16
1/25/2022,Wyoming,586107,35,9039,156,20
1/26/2022,Wyoming,586107,24,9063,165,18
1/27/2022,Wyoming,586107,31,9094,166,18
1/28/2022,Wyoming,586107,28,9122,170,23
1/29/2022,Wyoming,586107,28,9150,163,24
1/30/2022,Wyoming,586107,26,9176,166,26
1/31/2022,Wyoming,586107,24,9200,169,21
2/1/2022,Wyoming,586107,30,9230,171,15
2/2/2022,Wyoming,586107,29,9259,156,24
2/3/2022,Wyoming,586107,27,9286,149,20
2/4/2022,Wyoming,586107,30,9316,135,17
2/5/2022,Wyoming,586107,27,9343,123,18
2/6/2022,Wyoming,586107,27,9370,118,17
2/7/2022,Wyoming,586107,14,9384,114,18
2/8/2022,Wyoming,586107,22,9406,117,19
2/9/2022,Wyoming,586107,22,9428,117,19
